age,male,female,all,city,district
18-24,178,200,378,Çorum,Boğazkale
25-29,76,92,168,Çorum,Boğazkale
30-34,91,82,173,Çorum,Boğazkale
35-39,100,95,195,Çorum,Boğazkale
40-44,121,121,242,Çorum,Boğazkale
45-49,120,112,232,Çorum,Boğazkale
50-54,146,121,267,Çorum,Boğazkale
55-59,130,130,260,Çorum,Boğazkale
60-64,157,157,314,Çorum,Boğazkale
65-69,137,186,323,Çorum,Boğazkale
70-74,107,130,237,Çorum,Boğazkale
75+,147,184,331,Çorum,Boğazkale
18-24,17125,17871,34996,Kocaeli,İzmit
25-29,13542,13375,26917,Kocaeli,İzmit
30-34,14144,14164,28308,Kocaeli,İzmit
35-39,15310,15383,30693,Kocaeli,İzmit
40-44,13651,13955,27606,Kocaeli,İzmit
45-49,12072,12129,24201,Kocaeli,İzmit
50-54,10553,10653,21206,Kocaeli,İzmit
55-59,8644,9095,17739,Kocaeli,İzmit
60-64,7314,7697,15011,Kocaeli,İzmit
65-69,5366,5835,11201,Kocaeli,İzmit
70-74,3533,4068,7601,Kocaeli,İzmit
75+,4213,6086,10299,Kocaeli,İzmit
18-24,670,650,1320,Afyonkarahisar,Sultandağı
25-29,332,340,672,Afyonkarahisar,Sultandağı
30-34,382,374,756,Afyonkarahisar,Sultandağı
35-39,455,420,875,Afyonkarahisar,Sultandağı
40-44,420,473,893,Afyonkarahisar,Sultandağı
45-49,532,535,1067,Afyonkarahisar,Sultandağı
50-54,522,641,1163,Afyonkarahisar,Sultandağı
55-59,705,720,1425,Afyonkarahisar,Sultandağı
60-64,615,691,1306,Afyonkarahisar,Sultandağı
65-69,587,631,1218,Afyonkarahisar,Sultandağı
70-74,336,485,821,Afyonkarahisar,Sultandağı
75+,459,724,1183,Afyonkarahisar,Sultandağı
18-24,3063,2975,6038,Kahramanmaraş,Göksun
25-29,1744,1617,3361,Kahramanmaraş,Göksun
30-34,1764,1534,3298,Kahramanmaraş,Göksun
35-39,1681,1687,3368,Kahramanmaraş,Göksun
40-44,1452,1477,2929,Kahramanmaraş,Göksun
45-49,1553,1610,3163,Kahramanmaraş,Göksun
50-54,1560,1423,2983,Kahramanmaraş,Göksun
55-59,1288,1300,2588,Kahramanmaraş,Göksun
60-64,1177,1158,2335,Kahramanmaraş,Göksun
65-69,1078,1121,2199,Kahramanmaraş,Göksun
70-74,823,930,1753,Kahramanmaraş,Göksun
75+,1126,1416,2542,Kahramanmaraş,Göksun
18-24,2031,1984,4015,Giresun,Espiye
25-29,1076,1061,2137,Giresun,Espiye
30-34,1054,983,2037,Giresun,Espiye
35-39,1141,1065,2206,Giresun,Espiye
40-44,1097,954,2051,Giresun,Espiye
45-49,1025,978,2003,Giresun,Espiye
50-54,1104,1009,2113,Giresun,Espiye
55-59,1071,982,2053,Giresun,Espiye
60-64,1020,1034,2054,Giresun,Espiye
65-69,764,818,1582,Giresun,Espiye
70-74,407,658,1065,Giresun,Espiye
75+,859,1341,2200,Giresun,Espiye
18-24,2357,2254,4611,Batman,Beşiri
25-29,1188,1048,2236,Batman,Beşiri
30-34,815,774,1589,Batman,Beşiri
35-39,824,867,1691,Batman,Beşiri
40-44,656,724,1380,Batman,Beşiri
45-49,593,567,1160,Batman,Beşiri
50-54,536,504,1040,Batman,Beşiri
55-59,410,373,783,Batman,Beşiri
60-64,330,406,736,Batman,Beşiri
65-69,272,369,641,Batman,Beşiri
70-74,167,220,387,Batman,Beşiri
75+,249,432,681,Batman,Beşiri
18-24,6575,7218,13793,Ankara,Polatlı
25-29,4472,4544,9016,Ankara,Polatlı
30-34,4502,4569,9071,Ankara,Polatlı
35-39,4574,4707,9281,Ankara,Polatlı
40-44,4099,4246,8345,Ankara,Polatlı
45-49,3922,4130,8052,Ankara,Polatlı
50-54,3901,3982,7883,Ankara,Polatlı
55-59,3410,3286,6696,Ankara,Polatlı
60-64,2753,2765,5518,Ankara,Polatlı
65-69,1855,2207,4062,Ankara,Polatlı
70-74,1179,1511,2690,Ankara,Polatlı
75+,1653,2420,4073,Ankara,Polatlı
18-24,218,230,448,Karaman,Başyayla
25-29,112,104,216,Karaman,Başyayla
30-34,114,93,207,Karaman,Başyayla
35-39,107,106,213,Karaman,Başyayla
40-44,108,101,209,Karaman,Başyayla
45-49,134,139,273,Karaman,Başyayla
50-54,102,88,190,Karaman,Başyayla
55-59,105,96,201,Karaman,Başyayla
60-64,90,99,189,Karaman,Başyayla
65-69,69,95,164,Karaman,Başyayla
70-74,69,68,137,Karaman,Başyayla
75+,128,181,309,Karaman,Başyayla
18-24,10310,10422,20732,Erzurum,Palandöken
25-29,6483,6941,13424,Erzurum,Palandöken
30-34,6593,7027,13620,Erzurum,Palandöken
35-39,6693,6894,13587,Erzurum,Palandöken
40-44,5593,5657,11250,Erzurum,Palandöken
45-49,4752,4788,9540,Erzurum,Palandöken
50-54,4072,3901,7973,Erzurum,Palandöken
55-59,3234,3427,6661,Erzurum,Palandöken
60-64,2704,2950,5654,Erzurum,Palandöken
65-69,2036,2133,4169,Erzurum,Palandöken
70-74,1391,1613,3004,Erzurum,Palandöken
75+,1351,2205,3556,Erzurum,Palandöken
18-24,123,115,238,Kastamonu,Ağlı
25-29,88,80,168,Kastamonu,Ağlı
30-34,86,62,148,Kastamonu,Ağlı
35-39,88,73,161,Kastamonu,Ağlı
40-44,84,92,176,Kastamonu,Ağlı
45-49,73,71,144,Kastamonu,Ağlı
50-54,84,85,169,Kastamonu,Ağlı
55-59,105,113,218,Kastamonu,Ağlı
60-64,132,128,260,Kastamonu,Ağlı
65-69,86,108,194,Kastamonu,Ağlı
70-74,82,102,184,Kastamonu,Ağlı
75+,117,218,335,Kastamonu,Ağlı
18-24,1092,815,1907,Şırnak,Güçlükonak
25-29,757,484,1241,Şırnak,Güçlükonak
30-34,348,332,680,Şırnak,Güçlükonak
35-39,270,285,555,Şırnak,Güçlükonak
40-44,188,217,405,Şırnak,Güçlükonak
45-49,154,136,290,Şırnak,Güçlükonak
50-54,128,157,285,Şırnak,Güçlükonak
55-59,123,105,228,Şırnak,Güçlükonak
60-64,131,117,248,Şırnak,Güçlükonak
65-69,91,100,191,Şırnak,Güçlükonak
70-74,47,66,113,Şırnak,Güçlükonak
75+,89,131,220,Şırnak,Güçlükonak
18-24,1710,1672,3382,Balıkesir,Dursunbey
25-29,853,872,1725,Balıkesir,Dursunbey
30-34,933,910,1843,Balıkesir,Dursunbey
35-39,1034,1146,2180,Balıkesir,Dursunbey
40-44,1200,1203,2403,Balıkesir,Dursunbey
45-49,1195,1212,2407,Balıkesir,Dursunbey
50-54,1299,1380,2679,Balıkesir,Dursunbey
55-59,1281,1330,2611,Balıkesir,Dursunbey
60-64,1277,1381,2658,Balıkesir,Dursunbey
65-69,1028,1265,2293,Balıkesir,Dursunbey
70-74,866,1027,1893,Balıkesir,Dursunbey
75+,1224,1661,2885,Balıkesir,Dursunbey
18-24,1437,1390,2827,Kars,Selim
25-29,755,758,1513,Kars,Selim
30-34,744,665,1409,Kars,Selim
35-39,805,768,1573,Kars,Selim
40-44,709,612,1321,Kars,Selim
45-49,704,575,1279,Kars,Selim
50-54,608,532,1140,Kars,Selim
55-59,502,467,969,Kars,Selim
60-64,411,452,863,Kars,Selim
65-69,339,378,717,Kars,Selim
70-74,327,370,697,Kars,Selim
75+,411,475,886,Kars,Selim
18-24,235,246,481,Isparta,Atabey
25-29,151,155,306,Isparta,Atabey
30-34,197,137,334,Isparta,Atabey
35-39,178,169,347,Isparta,Atabey
40-44,152,166,318,Isparta,Atabey
45-49,180,193,373,Isparta,Atabey
50-54,173,173,346,Isparta,Atabey
55-59,202,224,426,Isparta,Atabey
60-64,188,186,374,Isparta,Atabey
65-69,134,162,296,Isparta,Atabey
70-74,72,95,167,Isparta,Atabey
75+,159,282,441,Isparta,Atabey
18-24,171,185,356,Eskişehir,Sarıcakaya
25-29,91,110,201,Eskişehir,Sarıcakaya
30-34,120,111,231,Eskişehir,Sarıcakaya
35-39,152,141,293,Eskişehir,Sarıcakaya
40-44,145,157,302,Eskişehir,Sarıcakaya
45-49,172,147,319,Eskişehir,Sarıcakaya
50-54,165,185,350,Eskişehir,Sarıcakaya
55-59,218,242,460,Eskişehir,Sarıcakaya
60-64,184,202,386,Eskişehir,Sarıcakaya
65-69,191,186,377,Eskişehir,Sarıcakaya
70-74,111,130,241,Eskişehir,Sarıcakaya
75+,222,322,544,Eskişehir,Sarıcakaya
18-24,14940,14698,29638,Antalya,Alanya
25-29,10269,9757,20026,Antalya,Alanya
30-34,11605,10805,22410,Antalya,Alanya
35-39,12939,12102,25041,Antalya,Alanya
40-44,12247,11601,23848,Antalya,Alanya
45-49,11145,10062,21207,Antalya,Alanya
50-54,9282,8404,17686,Antalya,Alanya
55-59,7332,6695,14027,Antalya,Alanya
60-64,5433,5110,10543,Antalya,Alanya
65-69,3721,3970,7691,Antalya,Alanya
70-74,2533,2675,5208,Antalya,Alanya
75+,3372,4147,7519,Antalya,Alanya
18-24,2354,2277,4631,Kayseri,Yahyalı
25-29,1311,1160,2471,Kayseri,Yahyalı
30-34,1245,1068,2313,Kayseri,Yahyalı
35-39,1131,1058,2189,Kayseri,Yahyalı
40-44,1007,1019,2026,Kayseri,Yahyalı
45-49,1136,1100,2236,Kayseri,Yahyalı
50-54,1087,994,2081,Kayseri,Yahyalı
55-59,1014,1072,2086,Kayseri,Yahyalı
60-64,831,915,1746,Kayseri,Yahyalı
65-69,682,770,1452,Kayseri,Yahyalı
70-74,526,624,1150,Kayseri,Yahyalı
75+,704,1177,1881,Kayseri,Yahyalı
18-24,6752,6774,13526,Şanlıurfa,Akçakale
25-29,3997,3670,7667,Şanlıurfa,Akçakale
30-34,3228,3016,6244,Şanlıurfa,Akçakale
35-39,2758,2708,5466,Şanlıurfa,Akçakale
40-44,2086,1919,4005,Şanlıurfa,Akçakale
45-49,1612,1575,3187,Şanlıurfa,Akçakale
50-54,1508,1429,2937,Şanlıurfa,Akçakale
55-59,791,1089,1880,Şanlıurfa,Akçakale
60-64,827,845,1672,Şanlıurfa,Akçakale
65-69,527,662,1189,Şanlıurfa,Akçakale
70-74,335,413,748,Şanlıurfa,Akçakale
75+,286,641,927,Şanlıurfa,Akçakale
18-24,657,654,1311,Kahramanmaraş,Nurhak
25-29,482,386,868,Kahramanmaraş,Nurhak
30-34,475,381,856,Kahramanmaraş,Nurhak
35-39,462,435,897,Kahramanmaraş,Nurhak
40-44,385,402,787,Kahramanmaraş,Nurhak
45-49,379,345,724,Kahramanmaraş,Nurhak
50-54,342,334,676,Kahramanmaraş,Nurhak
55-59,316,319,635,Kahramanmaraş,Nurhak
60-64,323,319,642,Kahramanmaraş,Nurhak
65-69,270,297,567,Kahramanmaraş,Nurhak
70-74,221,195,416,Kahramanmaraş,Nurhak
75+,299,390,689,Kahramanmaraş,Nurhak
18-24,11749,11764,23513,İstanbul,Büyükçekmece
25-29,8402,8821,17223,İstanbul,Büyükçekmece
30-34,9343,9947,19290,İstanbul,Büyükçekmece
35-39,10618,10972,21590,İstanbul,Büyükçekmece
40-44,9799,9902,19701,İstanbul,Büyükçekmece
45-49,8387,8492,16879,İstanbul,Büyükçekmece
50-54,7209,7150,14359,İstanbul,Büyükçekmece
55-59,6122,6048,12170,İstanbul,Büyükçekmece
60-64,4721,4840,9561,İstanbul,Büyükçekmece
65-69,3452,3815,7267,İstanbul,Büyükçekmece
70-74,2218,2584,4802,İstanbul,Büyükçekmece
75+,2548,3448,5996,İstanbul,Büyükçekmece
18-24,4302,4732,9034,Konya,Akşehir
25-29,2596,2790,5386,Konya,Akşehir
30-34,2930,2983,5913,Konya,Akşehir
35-39,3102,3156,6258,Konya,Akşehir
40-44,2954,3267,6221,Konya,Akşehir
45-49,2907,3289,6196,Konya,Akşehir
50-54,2915,3242,6157,Konya,Akşehir
55-59,3075,3390,6465,Konya,Akşehir
60-64,2542,2883,5425,Konya,Akşehir
65-69,2186,2467,4653,Konya,Akşehir
70-74,1540,1877,3417,Konya,Akşehir
75+,2030,2849,4879,Konya,Akşehir
18-24,716,759,1475,Erzurum,İspir
25-29,427,404,831,Erzurum,İspir
30-34,451,398,849,Erzurum,İspir
35-39,411,433,844,Erzurum,İspir
40-44,394,374,768,Erzurum,İspir
45-49,392,497,889,Erzurum,İspir
50-54,434,483,917,Erzurum,İspir
55-59,515,614,1129,Erzurum,İspir
60-64,605,691,1296,Erzurum,İspir
65-69,537,547,1084,Erzurum,İspir
70-74,430,538,968,Erzurum,İspir
75+,846,1022,1868,Erzurum,İspir
18-24,14212,14500,28712,İstanbul,Beylikdüzü
25-29,10603,12112,22715,İstanbul,Beylikdüzü
30-34,12604,14339,26943,İstanbul,Beylikdüzü
35-39,14371,15852,30223,İstanbul,Beylikdüzü
40-44,13198,13435,26633,İstanbul,Beylikdüzü
45-49,10977,11319,22296,İstanbul,Beylikdüzü
50-54,8886,8886,17772,İstanbul,Beylikdüzü
55-59,7215,7511,14726,İstanbul,Beylikdüzü
60-64,5443,5868,11311,İstanbul,Beylikdüzü
65-69,3877,4279,8156,İstanbul,Beylikdüzü
70-74,2413,2762,5175,İstanbul,Beylikdüzü
75+,2382,3667,6049,İstanbul,Beylikdüzü
18-24,7185,7729,14914,Hatay,Defne
25-29,4542,5071,9613,Hatay,Defne
30-34,5334,5893,11227,Hatay,Defne
35-39,5736,6444,12180,Hatay,Defne
40-44,5465,6027,11492,Hatay,Defne
45-49,5013,5410,10423,Hatay,Defne
50-54,4859,4866,9725,Hatay,Defne
55-59,3941,3966,7907,Hatay,Defne
60-64,3034,2993,6027,Hatay,Defne
65-69,1978,1976,3954,Hatay,Defne
70-74,1149,1251,2400,Hatay,Defne
75+,2025,2250,4275,Hatay,Defne
18-24,399,322,721,Rize,Derepazarı
25-29,215,202,417,Rize,Derepazarı
30-34,220,179,399,Rize,Derepazarı
35-39,216,200,416,Rize,Derepazarı
40-44,222,211,433,Rize,Derepazarı
45-49,274,258,532,Rize,Derepazarı
50-54,279,252,531,Rize,Derepazarı
55-59,266,251,517,Rize,Derepazarı
60-64,218,274,492,Rize,Derepazarı
65-69,166,206,372,Rize,Derepazarı
70-74,145,193,338,Rize,Derepazarı
75+,188,342,530,Rize,Derepazarı
18-24,1538,1744,3282,Hatay,Belen
25-29,1055,1114,2169,Hatay,Belen
30-34,1214,1229,2443,Hatay,Belen
35-39,1305,1252,2557,Hatay,Belen
40-44,1061,1073,2134,Hatay,Belen
45-49,1002,1029,2031,Hatay,Belen
50-54,984,970,1954,Hatay,Belen
55-59,828,971,1799,Hatay,Belen
60-64,770,776,1546,Hatay,Belen
65-69,669,638,1307,Hatay,Belen
70-74,428,392,820,Hatay,Belen
75+,452,524,976,Hatay,Belen
18-24,1287,1263,2550,Denizli,Buldan
25-29,784,726,1510,Denizli,Buldan
30-34,843,919,1762,Denizli,Buldan
35-39,1066,1041,2107,Denizli,Buldan
40-44,995,984,1979,Denizli,Buldan
45-49,914,984,1898,Denizli,Buldan
50-54,933,1001,1934,Denizli,Buldan
55-59,963,956,1919,Denizli,Buldan
60-64,770,816,1586,Denizli,Buldan
65-69,533,638,1171,Denizli,Buldan
70-74,410,489,899,Denizli,Buldan
75+,629,998,1627,Denizli,Buldan
18-24,1109,1097,2206,Sivas,Kangal
25-29,728,656,1384,Sivas,Kangal
30-34,663,629,1292,Sivas,Kangal
35-39,758,573,1331,Sivas,Kangal
40-44,661,572,1233,Sivas,Kangal
45-49,641,583,1224,Sivas,Kangal
50-54,650,648,1298,Sivas,Kangal
55-59,610,625,1235,Sivas,Kangal
60-64,713,617,1330,Sivas,Kangal
65-69,599,642,1241,Sivas,Kangal
70-74,505,526,1031,Sivas,Kangal
75+,654,901,1555,Sivas,Kangal
18-24,6153,6351,12504,Aydın,Söke
25-29,4287,3957,8244,Aydın,Söke
30-34,4190,4027,8217,Aydın,Söke
35-39,4346,4483,8829,Aydın,Söke
40-44,4235,4091,8326,Aydın,Söke
45-49,3941,3879,7820,Aydın,Söke
50-54,3755,3879,7634,Aydın,Söke
55-59,3692,3703,7395,Aydın,Söke
60-64,3146,3307,6453,Aydın,Söke
65-69,2347,2550,4897,Aydın,Söke
70-74,1563,1923,3486,Aydın,Söke
75+,2090,3222,5312,Aydın,Söke
18-24,2418,2366,4784,Trabzon,Of
25-29,1361,1379,2740,Trabzon,Of
30-34,1253,1203,2456,Trabzon,Of
35-39,1269,1303,2572,Trabzon,Of
40-44,1372,1289,2661,Trabzon,Of
45-49,1430,1462,2892,Trabzon,Of
50-54,1526,1509,3035,Trabzon,Of
55-59,1443,1380,2823,Trabzon,Of
60-64,1349,1383,2732,Trabzon,Of
65-69,1008,1130,2138,Trabzon,Of
70-74,650,892,1542,Trabzon,Of
75+,1001,1759,2760,Trabzon,Of
18-24,2699,2835,5534,Denizli,Acıpayam
25-29,1627,1458,3085,Denizli,Acıpayam
30-34,1767,1612,3379,Denizli,Acıpayam
35-39,1914,1767,3681,Denizli,Acıpayam
40-44,1981,1844,3825,Denizli,Acıpayam
45-49,1979,1896,3875,Denizli,Acıpayam
50-54,1982,1886,3868,Denizli,Acıpayam
55-59,1824,1915,3739,Denizli,Acıpayam
60-64,1569,1571,3140,Denizli,Acıpayam
65-69,1403,1536,2939,Denizli,Acıpayam
70-74,1065,1314,2379,Denizli,Acıpayam
75+,1596,2423,4019,Denizli,Acıpayam
18-24,4512,4557,9069,Mardin,Derik
25-29,2412,2367,4779,Mardin,Derik
30-34,1985,2021,4006,Mardin,Derik
35-39,1817,1765,3582,Mardin,Derik
40-44,1410,1499,2909,Mardin,Derik
45-49,1187,1248,2435,Mardin,Derik
50-54,1028,1008,2036,Mardin,Derik
55-59,654,737,1391,Mardin,Derik
60-64,531,570,1101,Mardin,Derik
65-69,338,571,909,Mardin,Derik
70-74,297,391,688,Mardin,Derik
75+,507,806,1313,Mardin,Derik
18-24,273,272,545,Artvin,Murgul
25-29,200,192,392,Artvin,Murgul
30-34,212,215,427,Artvin,Murgul
35-39,242,172,414,Artvin,Murgul
40-44,193,174,367,Artvin,Murgul
45-49,207,188,395,Artvin,Murgul
50-54,235,217,452,Artvin,Murgul
55-59,216,195,411,Artvin,Murgul
60-64,179,175,354,Artvin,Murgul
65-69,157,154,311,Artvin,Murgul
70-74,67,112,179,Artvin,Murgul
75+,110,174,284,Artvin,Murgul
18-24,2203,2107,4310,Afyonkarahisar,Sinanpaşa
25-29,1234,1193,2427,Afyonkarahisar,Sinanpaşa
30-34,1290,1152,2442,Afyonkarahisar,Sinanpaşa
35-39,1323,1219,2542,Afyonkarahisar,Sinanpaşa
40-44,1188,1249,2437,Afyonkarahisar,Sinanpaşa
45-49,1290,1292,2582,Afyonkarahisar,Sinanpaşa
50-54,1212,1258,2470,Afyonkarahisar,Sinanpaşa
55-59,1347,1309,2656,Afyonkarahisar,Sinanpaşa
60-64,1071,1204,2275,Afyonkarahisar,Sinanpaşa
65-69,929,965,1894,Afyonkarahisar,Sinanpaşa
70-74,652,831,1483,Afyonkarahisar,Sinanpaşa
75+,1054,1467,2521,Afyonkarahisar,Sinanpaşa
18-24,748,828,1576,Bursa,Orhaneli
25-29,522,516,1038,Bursa,Orhaneli
30-34,589,517,1106,Bursa,Orhaneli
35-39,548,574,1122,Bursa,Orhaneli
40-44,583,566,1149,Bursa,Orhaneli
45-49,604,631,1235,Bursa,Orhaneli
50-54,668,706,1374,Bursa,Orhaneli
55-59,729,807,1536,Bursa,Orhaneli
60-64,645,713,1358,Bursa,Orhaneli
65-69,604,744,1348,Bursa,Orhaneli
70-74,397,537,934,Bursa,Orhaneli
75+,745,950,1695,Bursa,Orhaneli
18-24,10699,11137,21836,Kırıkkale,Kırıkkale Merkez
25-29,6486,6808,13294,Kırıkkale,Kırıkkale Merkez
30-34,7005,6915,13920,Kırıkkale,Kırıkkale Merkez
35-39,6969,7252,14221,Kırıkkale,Kırıkkale Merkez
40-44,6465,6901,13366,Kırıkkale,Kırıkkale Merkez
45-49,6813,7030,13843,Kırıkkale,Kırıkkale Merkez
50-54,7097,6923,14020,Kırıkkale,Kırıkkale Merkez
55-59,6035,6009,12044,Kırıkkale,Kırıkkale Merkez
60-64,4932,5077,10009,Kırıkkale,Kırıkkale Merkez
65-69,3630,4123,7753,Kırıkkale,Kırıkkale Merkez
70-74,2352,2907,5259,Kırıkkale,Kırıkkale Merkez
75+,2807,4107,6914,Kırıkkale,Kırıkkale Merkez
18-24,214,250,464,Kütahya,Pazarlar
25-29,111,115,226,Kütahya,Pazarlar
30-34,132,95,227,Kütahya,Pazarlar
35-39,130,135,265,Kütahya,Pazarlar
40-44,168,152,320,Kütahya,Pazarlar
45-49,151,173,324,Kütahya,Pazarlar
50-54,201,197,398,Kütahya,Pazarlar
55-59,180,259,439,Kütahya,Pazarlar
60-64,229,210,439,Kütahya,Pazarlar
65-69,160,195,355,Kütahya,Pazarlar
70-74,122,165,287,Kütahya,Pazarlar
75+,167,255,422,Kütahya,Pazarlar
18-24,1393,1418,2811,Karaman,Ermenek
25-29,931,852,1783,Karaman,Ermenek
30-34,939,859,1798,Karaman,Ermenek
35-39,973,906,1879,Karaman,Ermenek
40-44,875,821,1696,Karaman,Ermenek
45-49,946,926,1872,Karaman,Ermenek
50-54,925,910,1835,Karaman,Ermenek
55-59,756,734,1490,Karaman,Ermenek
60-64,694,782,1476,Karaman,Ermenek
65-69,574,677,1251,Karaman,Ermenek
70-74,521,675,1196,Karaman,Ermenek
75+,973,1148,2121,Karaman,Ermenek
18-24,397,395,792,Malatya,Kuluncak
25-29,205,176,381,Malatya,Kuluncak
30-34,203,161,364,Malatya,Kuluncak
35-39,212,207,419,Malatya,Kuluncak
40-44,208,193,401,Malatya,Kuluncak
45-49,227,243,470,Malatya,Kuluncak
50-54,272,263,535,Malatya,Kuluncak
55-59,259,264,523,Malatya,Kuluncak
60-64,272,280,552,Malatya,Kuluncak
65-69,236,244,480,Malatya,Kuluncak
70-74,189,237,426,Malatya,Kuluncak
75+,271,382,653,Malatya,Kuluncak
18-24,9754,9963,19717,Bingöl,Bingöl Merkez
25-29,7208,7449,14657,Bingöl,Bingöl Merkez
30-34,6639,6510,13149,Bingöl,Bingöl Merkez
35-39,6449,6461,12910,Bingöl,Bingöl Merkez
40-44,4827,5052,9879,Bingöl,Bingöl Merkez
45-49,4130,3973,8103,Bingöl,Bingöl Merkez
50-54,3467,3251,6718,Bingöl,Bingöl Merkez
55-59,2553,2498,5051,Bingöl,Bingöl Merkez
60-64,1962,2183,4145,Bingöl,Bingöl Merkez
65-69,1400,1689,3089,Bingöl,Bingöl Merkez
70-74,1007,1220,2227,Bingöl,Bingöl Merkez
75+,1470,1772,3242,Bingöl,Bingöl Merkez
18-24,2096,1938,4034,Kahramanmaraş,Andırın
25-29,954,825,1779,Kahramanmaraş,Andırın
30-34,980,863,1843,Kahramanmaraş,Andırın
35-39,1055,990,2045,Kahramanmaraş,Andırın
40-44,963,953,1916,Kahramanmaraş,Andırın
45-49,1031,1134,2165,Kahramanmaraş,Andırın
50-54,1032,1068,2100,Kahramanmaraş,Andırın
55-59,1060,983,2043,Kahramanmaraş,Andırın
60-64,978,1034,2012,Kahramanmaraş,Andırın
65-69,762,921,1683,Kahramanmaraş,Andırın
70-74,588,743,1331,Kahramanmaraş,Andırın
75+,1014,1132,2146,Kahramanmaraş,Andırın
18-24,441,396,837,Giresun,Güce
25-29,265,186,451,Giresun,Güce
30-34,203,177,380,Giresun,Güce
35-39,208,210,418,Giresun,Güce
40-44,213,176,389,Giresun,Güce
45-49,246,225,471,Giresun,Güce
50-54,299,271,570,Giresun,Güce
55-59,313,283,596,Giresun,Güce
60-64,274,299,573,Giresun,Güce
65-69,197,226,423,Giresun,Güce
70-74,135,177,312,Giresun,Güce
75+,246,400,646,Giresun,Güce
18-24,1106,1101,2207,Trabzon,Maçka
25-29,849,661,1510,Trabzon,Maçka
30-34,807,625,1432,Trabzon,Maçka
35-39,713,628,1341,Trabzon,Maçka
40-44,658,560,1218,Trabzon,Maçka
45-49,671,684,1355,Trabzon,Maçka
50-54,841,792,1633,Trabzon,Maçka
55-59,872,908,1780,Trabzon,Maçka
60-64,911,953,1864,Trabzon,Maçka
65-69,771,804,1575,Trabzon,Maçka
70-74,470,607,1077,Trabzon,Maçka
75+,787,1464,2251,Trabzon,Maçka
18-24,4701,4576,9277,Adıyaman,Besni
25-29,2481,2464,4945,Adıyaman,Besni
30-34,2582,2384,4966,Adıyaman,Besni
35-39,2659,2612,5271,Adıyaman,Besni
40-44,2296,2410,4706,Adıyaman,Besni
45-49,2187,2022,4209,Adıyaman,Besni
50-54,1924,1778,3702,Adıyaman,Besni
55-59,1729,1563,3292,Adıyaman,Besni
60-64,1471,1485,2956,Adıyaman,Besni
65-69,1208,1419,2627,Adıyaman,Besni
70-74,790,1069,1859,Adıyaman,Besni
75+,1174,1943,3117,Adıyaman,Besni
18-24,1605,1681,3286,Adana,İmamoğlu
25-29,870,815,1685,Adana,İmamoğlu
30-34,852,860,1712,Adana,İmamoğlu
35-39,1024,896,1920,Adana,İmamoğlu
40-44,929,889,1818,Adana,İmamoğlu
45-49,964,939,1903,Adana,İmamoğlu
50-54,953,980,1933,Adana,İmamoğlu
55-59,873,850,1723,Adana,İmamoğlu
60-64,674,697,1371,Adana,İmamoğlu
65-69,512,558,1070,Adana,İmamoğlu
70-74,311,430,741,Adana,İmamoğlu
75+,436,658,1094,Adana,İmamoğlu
18-24,1149,1361,2510,Konya,Yunak
25-29,678,714,1392,Konya,Yunak
30-34,693,602,1295,Konya,Yunak
35-39,751,660,1411,Konya,Yunak
40-44,665,602,1267,Konya,Yunak
45-49,676,682,1358,Konya,Yunak
50-54,754,764,1518,Konya,Yunak
55-59,699,657,1356,Konya,Yunak
60-64,557,680,1237,Konya,Yunak
65-69,530,624,1154,Konya,Yunak
70-74,347,449,796,Konya,Yunak
75+,389,599,988,Konya,Yunak
18-24,1903,1776,3679,Afyonkarahisar,Şuhut
25-29,1027,1074,2101,Afyonkarahisar,Şuhut
30-34,1167,1190,2357,Afyonkarahisar,Şuhut
35-39,1210,1110,2320,Afyonkarahisar,Şuhut
40-44,1189,1202,2391,Afyonkarahisar,Şuhut
45-49,1201,1191,2392,Afyonkarahisar,Şuhut
50-54,1180,1269,2449,Afyonkarahisar,Şuhut
55-59,1280,1349,2629,Afyonkarahisar,Şuhut
60-64,1017,1102,2119,Afyonkarahisar,Şuhut
65-69,792,980,1772,Afyonkarahisar,Şuhut
70-74,628,755,1383,Afyonkarahisar,Şuhut
75+,873,1257,2130,Afyonkarahisar,Şuhut
18-24,6365,6529,12894,İstanbul,Beşiktaş
25-29,6155,6931,13086,İstanbul,Beşiktaş
30-34,6923,7784,14707,İstanbul,Beşiktaş
35-39,7303,8664,15967,İstanbul,Beşiktaş
40-44,6634,7712,14346,İstanbul,Beşiktaş
45-49,5942,6991,12933,İstanbul,Beşiktaş
50-54,5072,6129,11201,İstanbul,Beşiktaş
55-59,4612,5557,10169,İstanbul,Beşiktaş
60-64,4000,5200,9200,İstanbul,Beşiktaş
65-69,3336,4223,7559,İstanbul,Beşiktaş
70-74,2596,3735,6331,İstanbul,Beşiktaş
75+,4400,7961,12361,İstanbul,Beşiktaş
18-24,885,840,1725,Adana,Feke
25-29,578,388,966,Adana,Feke
30-34,528,436,964,Adana,Feke
35-39,578,463,1041,Adana,Feke
40-44,571,467,1038,Adana,Feke
45-49,625,550,1175,Adana,Feke
50-54,535,479,1014,Adana,Feke
55-59,527,513,1040,Adana,Feke
60-64,501,481,982,Adana,Feke
65-69,380,407,787,Adana,Feke
70-74,304,362,666,Adana,Feke
75+,563,603,1166,Adana,Feke
18-24,348,329,677,Ankara,Çamlıdere
25-29,229,180,409,Ankara,Çamlıdere
30-34,226,132,358,Ankara,Çamlıdere
35-39,210,152,362,Ankara,Çamlıdere
40-44,238,199,437,Ankara,Çamlıdere
45-49,231,206,437,Ankara,Çamlıdere
50-54,300,268,568,Ankara,Çamlıdere
55-59,307,290,597,Ankara,Çamlıdere
60-64,313,307,620,Ankara,Çamlıdere
65-69,268,354,622,Ankara,Çamlıdere
70-74,253,264,517,Ankara,Çamlıdere
75+,368,589,957,Ankara,Çamlıdere
18-24,7018,7032,14050,Kocaeli,Çayırova
25-29,5604,5937,11541,Kocaeli,Çayırova
30-34,6482,6353,12835,Kocaeli,Çayırova
35-39,6693,6129,12822,Kocaeli,Çayırova
40-44,5380,4802,10182,Kocaeli,Çayırova
45-49,4232,3750,7982,Kocaeli,Çayırova
50-54,3361,3002,6363,Kocaeli,Çayırova
55-59,2388,2198,4586,Kocaeli,Çayırova
60-64,1577,1608,3185,Kocaeli,Çayırova
65-69,913,1015,1928,Kocaeli,Çayırova
70-74,504,674,1178,Kocaeli,Çayırova
75+,588,976,1564,Kocaeli,Çayırova
18-24,6235,6163,12398,Muğla,Milas
25-29,4818,4624,9442,Muğla,Milas
30-34,4964,4934,9898,Muğla,Milas
35-39,5324,5071,10395,Muğla,Milas
40-44,5076,4765,9841,Muğla,Milas
45-49,4928,4869,9797,Muğla,Milas
50-54,5121,4934,10055,Muğla,Milas
55-59,4869,4647,9516,Muğla,Milas
60-64,4139,3949,8088,Muğla,Milas
65-69,3058,3156,6214,Muğla,Milas
70-74,2260,2391,4651,Muğla,Milas
75+,3445,4414,7859,Muğla,Milas
18-24,1316,1409,2725,Tekirdağ,Hayrabolu
25-29,1104,919,2023,Tekirdağ,Hayrabolu
30-34,1085,905,1990,Tekirdağ,Hayrabolu
35-39,1089,920,2009,Tekirdağ,Hayrabolu
40-44,973,896,1869,Tekirdağ,Hayrabolu
45-49,1070,1066,2136,Tekirdağ,Hayrabolu
50-54,1188,1180,2368,Tekirdağ,Hayrabolu
55-59,1273,1246,2519,Tekirdağ,Hayrabolu
60-64,1084,1154,2238,Tekirdağ,Hayrabolu
65-69,854,927,1781,Tekirdağ,Hayrabolu
70-74,611,701,1312,Tekirdağ,Hayrabolu
75+,908,1265,2173,Tekirdağ,Hayrabolu
18-24,1194,1086,2280,Ordu,Akkuş
25-29,645,486,1131,Ordu,Akkuş
30-34,592,461,1053,Ordu,Akkuş
35-39,650,547,1197,Ordu,Akkuş
40-44,641,523,1164,Ordu,Akkuş
45-49,662,573,1235,Ordu,Akkuş
50-54,721,639,1360,Ordu,Akkuş
55-59,771,777,1548,Ordu,Akkuş
60-64,922,911,1833,Ordu,Akkuş
65-69,717,833,1550,Ordu,Akkuş
70-74,572,646,1218,Ordu,Akkuş
75+,889,1151,2040,Ordu,Akkuş
18-24,380,318,698,Kırşehir,Akpınar
25-29,218,168,386,Kırşehir,Akpınar
30-34,212,140,352,Kırşehir,Akpınar
35-39,222,177,399,Kırşehir,Akpınar
40-44,194,194,388,Kırşehir,Akpınar
45-49,233,211,444,Kırşehir,Akpınar
50-54,274,294,568,Kırşehir,Akpınar
55-59,340,315,655,Kırşehir,Akpınar
60-64,272,346,618,Kırşehir,Akpınar
65-69,212,285,497,Kırşehir,Akpınar
70-74,160,227,387,Kırşehir,Akpınar
75+,204,359,563,Kırşehir,Akpınar
18-24,985,1014,1999,Trabzon,Beşikdüzü
25-29,620,574,1194,Trabzon,Beşikdüzü
30-34,544,585,1129,Trabzon,Beşikdüzü
35-39,626,643,1269,Trabzon,Beşikdüzü
40-44,574,659,1233,Trabzon,Beşikdüzü
45-49,687,728,1415,Trabzon,Beşikdüzü
50-54,786,828,1614,Trabzon,Beşikdüzü
55-59,855,792,1647,Trabzon,Beşikdüzü
60-64,717,789,1506,Trabzon,Beşikdüzü
65-69,514,567,1081,Trabzon,Beşikdüzü
70-74,329,482,811,Trabzon,Beşikdüzü
75+,732,1241,1973,Trabzon,Beşikdüzü
18-24,4891,5664,10555,Hatay,Reyhanlı
25-29,3145,3160,6305,Hatay,Reyhanlı
30-34,3301,3108,6409,Hatay,Reyhanlı
35-39,3084,2992,6076,Hatay,Reyhanlı
40-44,2526,2578,5104,Hatay,Reyhanlı
45-49,2260,2303,4563,Hatay,Reyhanlı
50-54,2174,2081,4255,Hatay,Reyhanlı
55-59,1706,1797,3503,Hatay,Reyhanlı
60-64,1367,1460,2827,Hatay,Reyhanlı
65-69,909,1069,1978,Hatay,Reyhanlı
70-74,517,705,1222,Hatay,Reyhanlı
75+,733,1111,1844,Hatay,Reyhanlı
18-24,3508,3431,6939,Edirne,Keşan
25-29,2710,2593,5303,Edirne,Keşan
30-34,2894,2776,5670,Edirne,Keşan
35-39,2977,2986,5963,Edirne,Keşan
40-44,2925,2832,5757,Edirne,Keşan
45-49,2732,2784,5516,Edirne,Keşan
50-54,2852,2911,5763,Edirne,Keşan
55-59,2796,2901,5697,Edirne,Keşan
60-64,2451,2533,4984,Edirne,Keşan
65-69,2009,2099,4108,Edirne,Keşan
70-74,1299,1530,2829,Edirne,Keşan
75+,1599,2408,4007,Edirne,Keşan
18-24,2064,1960,4024,Sivas,Yıldızeli
25-29,1205,949,2154,Sivas,Yıldızeli
30-34,1024,907,1931,Sivas,Yıldızeli
35-39,1123,978,2101,Sivas,Yıldızeli
40-44,912,921,1833,Sivas,Yıldızeli
45-49,860,908,1768,Sivas,Yıldızeli
50-54,985,948,1933,Sivas,Yıldızeli
55-59,964,954,1918,Sivas,Yıldızeli
60-64,949,919,1868,Sivas,Yıldızeli
65-69,746,860,1606,Sivas,Yıldızeli
70-74,621,690,1311,Sivas,Yıldızeli
75+,794,971,1765,Sivas,Yıldızeli
18-24,1809,1964,3773,Manisa,Demirci
25-29,905,954,1859,Manisa,Demirci
30-34,1008,1034,2042,Manisa,Demirci
35-39,1145,1229,2374,Manisa,Demirci
40-44,1331,1318,2649,Manisa,Demirci
45-49,1426,1474,2900,Manisa,Demirci
50-54,1374,1435,2809,Manisa,Demirci
55-59,1377,1488,2865,Manisa,Demirci
60-64,1203,1313,2516,Manisa,Demirci
65-69,1020,1154,2174,Manisa,Demirci
70-74,730,810,1540,Manisa,Demirci
75+,1222,1543,2765,Manisa,Demirci
18-24,1494,1497,2991,Ankara,Şereflikoçhisar
25-29,1013,910,1923,Ankara,Şereflikoçhisar
30-34,1049,1055,2104,Ankara,Şereflikoçhisar
35-39,1177,1096,2273,Ankara,Şereflikoçhisar
40-44,1127,947,2074,Ankara,Şereflikoçhisar
45-49,1004,1009,2013,Ankara,Şereflikoçhisar
50-54,1046,1097,2143,Ankara,Şereflikoçhisar
55-59,1066,1085,2151,Ankara,Şereflikoçhisar
60-64,903,1014,1917,Ankara,Şereflikoçhisar
65-69,843,964,1807,Ankara,Şereflikoçhisar
70-74,537,756,1293,Ankara,Şereflikoçhisar
75+,740,1163,1903,Ankara,Şereflikoçhisar
18-24,21243,21815,43058,İstanbul,Sultanbeyli
25-29,15869,15018,30887,İstanbul,Sultanbeyli
30-34,15048,13939,28987,İstanbul,Sultanbeyli
35-39,14902,13666,28568,İstanbul,Sultanbeyli
40-44,11691,10230,21921,İstanbul,Sultanbeyli
45-49,9496,8509,18005,İstanbul,Sultanbeyli
50-54,7656,6988,14644,İstanbul,Sultanbeyli
55-59,5809,5029,10838,İstanbul,Sultanbeyli
60-64,3686,3472,7158,İstanbul,Sultanbeyli
65-69,1912,2146,4058,İstanbul,Sultanbeyli
70-74,1066,1396,2462,İstanbul,Sultanbeyli
75+,1233,2122,3355,İstanbul,Sultanbeyli
18-24,385,368,753,Sinop,Erfelek
25-29,275,204,479,Sinop,Erfelek
30-34,257,229,486,Sinop,Erfelek
35-39,297,249,546,Sinop,Erfelek
40-44,317,269,586,Sinop,Erfelek
45-49,294,268,562,Sinop,Erfelek
50-54,373,376,749,Sinop,Erfelek
55-59,500,447,947,Sinop,Erfelek
60-64,489,532,1021,Sinop,Erfelek
65-69,527,559,1086,Sinop,Erfelek
70-74,414,477,891,Sinop,Erfelek
75+,625,850,1475,Sinop,Erfelek
18-24,5889,4792,10681,Hakkari,Şemdinli
25-29,5015,2547,7562,Hakkari,Şemdinli
30-34,2227,1866,4093,Hakkari,Şemdinli
35-39,2210,2224,4434,Hakkari,Şemdinli
40-44,1105,1152,2257,Hakkari,Şemdinli
45-49,822,769,1591,Hakkari,Şemdinli
50-54,734,762,1496,Hakkari,Şemdinli
55-59,609,652,1261,Hakkari,Şemdinli
60-64,343,411,754,Hakkari,Şemdinli
65-69,336,351,687,Hakkari,Şemdinli
70-74,160,197,357,Hakkari,Şemdinli
75+,238,514,752,Hakkari,Şemdinli
18-24,5239,5352,10591,İzmir,Kemalpaşa
25-29,3950,3941,7891,İzmir,Kemalpaşa
30-34,4369,4295,8664,İzmir,Kemalpaşa
35-39,4748,4500,9248,İzmir,Kemalpaşa
40-44,4256,3894,8150,İzmir,Kemalpaşa
45-49,3589,3447,7036,İzmir,Kemalpaşa
50-54,3351,3144,6495,İzmir,Kemalpaşa
55-59,3089,2757,5846,İzmir,Kemalpaşa
60-64,2206,2202,4408,İzmir,Kemalpaşa
65-69,1656,1670,3326,İzmir,Kemalpaşa
70-74,1084,1201,2285,İzmir,Kemalpaşa
75+,1449,2098,3547,İzmir,Kemalpaşa
18-24,1071,1058,2129,Samsun,Kavak
25-29,633,578,1211,Samsun,Kavak
30-34,612,468,1080,Samsun,Kavak
35-39,636,600,1236,Samsun,Kavak
40-44,610,599,1209,Samsun,Kavak
45-49,646,638,1284,Samsun,Kavak
50-54,654,691,1345,Samsun,Kavak
55-59,671,684,1355,Samsun,Kavak
60-64,677,678,1355,Samsun,Kavak
65-69,575,651,1226,Samsun,Kavak
70-74,462,549,1011,Samsun,Kavak
75+,702,947,1649,Samsun,Kavak
18-24,1053,938,1991,Mardin,Ömerli
25-29,561,511,1072,Mardin,Ömerli
30-34,419,415,834,Mardin,Ömerli
35-39,397,358,755,Mardin,Ömerli
40-44,336,344,680,Mardin,Ömerli
45-49,347,321,668,Mardin,Ömerli
50-54,275,249,524,Mardin,Ömerli
55-59,231,219,450,Mardin,Ömerli
60-64,196,169,365,Mardin,Ömerli
65-69,159,193,352,Mardin,Ömerli
70-74,126,178,304,Mardin,Ömerli
75+,291,351,642,Mardin,Ömerli
18-24,270,201,471,Tokat,Başçiftlik
25-29,177,118,295,Tokat,Başçiftlik
30-34,127,93,220,Tokat,Başçiftlik
35-39,115,92,207,Tokat,Başçiftlik
40-44,141,100,241,Tokat,Başçiftlik
45-49,134,131,265,Tokat,Başçiftlik
50-54,157,193,350,Tokat,Başçiftlik
55-59,168,183,351,Tokat,Başçiftlik
60-64,185,191,376,Tokat,Başçiftlik
65-69,119,180,299,Tokat,Başçiftlik
70-74,143,153,296,Tokat,Başçiftlik
75+,208,250,458,Tokat,Başçiftlik
18-24,1927,2092,4019,Yozgat,Yerköy
25-29,1000,1104,2104,Yozgat,Yerköy
30-34,1049,1106,2155,Yozgat,Yerköy
35-39,1218,1219,2437,Yozgat,Yerköy
40-44,1112,1178,2290,Yozgat,Yerköy
45-49,1256,1191,2447,Yozgat,Yerköy
50-54,1283,1300,2583,Yozgat,Yerköy
55-59,1081,1185,2266,Yozgat,Yerköy
60-64,965,1003,1968,Yozgat,Yerköy
65-69,834,899,1733,Yozgat,Yerköy
70-74,531,693,1224,Yozgat,Yerköy
75+,717,1151,1868,Yozgat,Yerköy
18-24,203,77,280,Tunceli,Nazımiye
25-29,250,68,318,Tunceli,Nazımiye
30-34,135,73,208,Tunceli,Nazımiye
35-39,137,76,213,Tunceli,Nazımiye
40-44,106,73,179,Tunceli,Nazımiye
45-49,107,80,187,Tunceli,Nazımiye
50-54,74,71,145,Tunceli,Nazımiye
55-59,87,104,191,Tunceli,Nazımiye
60-64,134,131,265,Tunceli,Nazımiye
65-69,113,141,254,Tunceli,Nazımiye
70-74,81,97,178,Tunceli,Nazımiye
75+,194,198,392,Tunceli,Nazımiye
18-24,5108,5310,10418,Şanlıurfa,Harran
25-29,2888,2949,5837,Şanlıurfa,Harran
30-34,2372,2406,4778,Şanlıurfa,Harran
35-39,2125,2168,4293,Şanlıurfa,Harran
40-44,1477,1516,2993,Şanlıurfa,Harran
45-49,1285,1196,2481,Şanlıurfa,Harran
50-54,1118,1109,2227,Şanlıurfa,Harran
55-59,596,729,1325,Şanlıurfa,Harran
60-64,656,595,1251,Şanlıurfa,Harran
65-69,324,508,832,Şanlıurfa,Harran
70-74,225,374,599,Şanlıurfa,Harran
75+,222,479,701,Şanlıurfa,Harran
18-24,327,251,578,Tunceli,Ovacık
25-29,480,162,642,Tunceli,Ovacık
30-34,273,152,425,Tunceli,Ovacık
35-39,262,182,444,Tunceli,Ovacık
40-44,243,185,428,Tunceli,Ovacık
45-49,244,205,449,Tunceli,Ovacık
50-54,225,195,420,Tunceli,Ovacık
55-59,236,210,446,Tunceli,Ovacık
60-64,215,223,438,Tunceli,Ovacık
65-69,188,204,392,Tunceli,Ovacık
70-74,100,159,259,Tunceli,Ovacık
75+,225,260,485,Tunceli,Ovacık
18-24,590,483,1073,Konya,Güneysınır
25-29,281,264,545,Konya,Güneysınır
30-34,316,255,571,Konya,Güneysınır
35-39,262,271,533,Konya,Güneysınır
40-44,263,257,520,Konya,Güneysınır
45-49,286,290,576,Konya,Güneysınır
50-54,290,294,584,Konya,Güneysınır
55-59,261,299,560,Konya,Güneysınır
60-64,231,268,499,Konya,Güneysınır
65-69,201,232,433,Konya,Güneysınır
70-74,117,183,300,Konya,Güneysınır
75+,259,303,562,Konya,Güneysınır
18-24,3035,3055,6090,Kars,Kağızman
25-29,2064,1744,3808,Kars,Kağızman
30-34,1512,1297,2809,Kars,Kağızman
35-39,1510,1451,2961,Kars,Kağızman
40-44,1252,1140,2392,Kars,Kağızman
45-49,1065,966,2031,Kars,Kağızman
50-54,979,885,1864,Kars,Kağızman
55-59,909,779,1688,Kars,Kağızman
60-64,673,756,1429,Kars,Kağızman
65-69,441,544,985,Kars,Kağızman
70-74,433,549,982,Kars,Kağızman
75+,607,737,1344,Kars,Kağızman
18-24,1196,1215,2411,Adana,Karataş
25-29,789,716,1505,Adana,Karataş
30-34,834,678,1512,Adana,Karataş
35-39,810,749,1559,Adana,Karataş
40-44,792,710,1502,Adana,Karataş
45-49,721,677,1398,Adana,Karataş
50-54,746,664,1410,Adana,Karataş
55-59,748,603,1351,Adana,Karataş
60-64,631,567,1198,Adana,Karataş
65-69,444,446,890,Adana,Karataş
70-74,288,300,588,Adana,Karataş
75+,316,511,827,Adana,Karataş
18-24,922,976,1898,Osmaniye,Toprakkale
25-29,549,558,1107,Osmaniye,Toprakkale
30-34,637,612,1249,Osmaniye,Toprakkale
35-39,614,595,1209,Osmaniye,Toprakkale
40-44,534,511,1045,Osmaniye,Toprakkale
45-49,531,473,1004,Osmaniye,Toprakkale
50-54,450,398,848,Osmaniye,Toprakkale
55-59,380,377,757,Osmaniye,Toprakkale
60-64,317,303,620,Osmaniye,Toprakkale
65-69,205,226,431,Osmaniye,Toprakkale
70-74,118,165,283,Osmaniye,Toprakkale
75+,149,261,410,Osmaniye,Toprakkale
18-24,807,747,1554,Ordu,Çatalpınar
25-29,429,391,820,Ordu,Çatalpınar
30-34,448,384,832,Ordu,Çatalpınar
35-39,466,440,906,Ordu,Çatalpınar
40-44,485,425,910,Ordu,Çatalpınar
45-49,441,441,882,Ordu,Çatalpınar
50-54,475,441,916,Ordu,Çatalpınar
55-59,399,414,813,Ordu,Çatalpınar
60-64,335,358,693,Ordu,Çatalpınar
65-69,292,315,607,Ordu,Çatalpınar
70-74,164,257,421,Ordu,Çatalpınar
75+,204,337,541,Ordu,Çatalpınar
18-24,481,438,919,Isparta,Sütçüler
25-29,312,228,540,Isparta,Sütçüler
30-34,277,200,477,Isparta,Sütçüler
35-39,283,244,527,Isparta,Sütçüler
40-44,296,280,576,Isparta,Sütçüler
45-49,286,277,563,Isparta,Sütçüler
50-54,312,321,633,Isparta,Sütçüler
55-59,336,398,734,Isparta,Sütçüler
60-64,399,449,848,Isparta,Sütçüler
65-69,384,420,804,Isparta,Sütçüler
70-74,299,393,692,Isparta,Sütçüler
75+,585,765,1350,Isparta,Sütçüler
18-24,7931,8654,16585,Kayseri,Talas
25-29,5764,6317,12081,Kayseri,Talas
30-34,6290,6769,13059,Kayseri,Talas
35-39,6588,6709,13297,Kayseri,Talas
40-44,5529,5679,11208,Kayseri,Talas
45-49,4737,4676,9413,Kayseri,Talas
50-54,3975,3878,7853,Kayseri,Talas
55-59,3225,3286,6511,Kayseri,Talas
60-64,2501,2539,5040,Kayseri,Talas
65-69,1848,1917,3765,Kayseri,Talas
70-74,1082,1297,2379,Kayseri,Talas
75+,1120,1684,2804,Kayseri,Talas
18-24,922,1009,1931,Zonguldak,Gökçebey
25-29,630,557,1187,Zonguldak,Gökçebey
30-34,711,678,1389,Zonguldak,Gökçebey
35-39,786,757,1543,Zonguldak,Gökçebey
40-44,715,713,1428,Zonguldak,Gökçebey
45-49,733,800,1533,Zonguldak,Gökçebey
50-54,748,849,1597,Zonguldak,Gökçebey
55-59,740,838,1578,Zonguldak,Gökçebey
60-64,703,784,1487,Zonguldak,Gökçebey
65-69,597,606,1203,Zonguldak,Gökçebey
70-74,353,384,737,Zonguldak,Gökçebey
75+,422,688,1110,Zonguldak,Gökçebey
18-24,2230,2250,4480,Rize,Ardeşen
25-29,1406,1393,2799,Rize,Ardeşen
30-34,1433,1388,2821,Rize,Ardeşen
35-39,1489,1487,2976,Rize,Ardeşen
40-44,1471,1440,2911,Rize,Ardeşen
45-49,1631,1566,3197,Rize,Ardeşen
50-54,1424,1307,2731,Rize,Ardeşen
55-59,1215,1085,2300,Rize,Ardeşen
60-64,962,967,1929,Rize,Ardeşen
65-69,630,640,1270,Rize,Ardeşen
70-74,458,653,1111,Rize,Ardeşen
75+,728,1408,2136,Rize,Ardeşen
18-24,2342,2550,4892,Sakarya,Geyve
25-29,1661,1592,3253,Sakarya,Geyve
30-34,1669,1582,3251,Sakarya,Geyve
35-39,1934,1846,3780,Sakarya,Geyve
40-44,1724,1698,3422,Sakarya,Geyve
45-49,1565,1521,3086,Sakarya,Geyve
50-54,1409,1471,2880,Sakarya,Geyve
55-59,1414,1378,2792,Sakarya,Geyve
60-64,1214,1305,2519,Sakarya,Geyve
65-69,950,1028,1978,Sakarya,Geyve
70-74,632,796,1428,Sakarya,Geyve
75+,1025,1365,2390,Sakarya,Geyve
18-24,1277,1214,2491,Giresun,Şebinkarahisar
25-29,664,570,1234,Giresun,Şebinkarahisar
30-34,567,540,1107,Giresun,Şebinkarahisar
35-39,612,532,1144,Giresun,Şebinkarahisar
40-44,590,500,1090,Giresun,Şebinkarahisar
45-49,533,577,1110,Giresun,Şebinkarahisar
50-54,569,547,1116,Giresun,Şebinkarahisar
55-59,639,641,1280,Giresun,Şebinkarahisar
60-64,728,737,1465,Giresun,Şebinkarahisar
65-69,610,631,1241,Giresun,Şebinkarahisar
70-74,469,535,1004,Giresun,Şebinkarahisar
75+,689,1014,1703,Giresun,Şebinkarahisar
18-24,1659,1686,3345,Erzurum,Karaçoban
25-29,888,781,1669,Erzurum,Karaçoban
30-34,654,638,1292,Erzurum,Karaçoban
35-39,617,649,1266,Erzurum,Karaçoban
40-44,528,540,1068,Erzurum,Karaçoban
45-49,474,472,946,Erzurum,Karaçoban
50-54,415,338,753,Erzurum,Karaçoban
55-59,294,304,598,Erzurum,Karaçoban
60-64,276,315,591,Erzurum,Karaçoban
65-69,215,278,493,Erzurum,Karaçoban
70-74,143,191,334,Erzurum,Karaçoban
75+,196,294,490,Erzurum,Karaçoban
18-24,2563,2607,5170,Bitlis,Ahlat
25-29,1591,1594,3185,Bitlis,Ahlat
30-34,1344,1234,2578,Bitlis,Ahlat
35-39,1408,1289,2697,Bitlis,Ahlat
40-44,920,828,1748,Bitlis,Ahlat
45-49,935,854,1789,Bitlis,Ahlat
50-54,796,740,1536,Bitlis,Ahlat
55-59,650,587,1237,Bitlis,Ahlat
60-64,561,517,1078,Bitlis,Ahlat
65-69,340,459,799,Bitlis,Ahlat
70-74,258,292,550,Bitlis,Ahlat
75+,349,444,793,Bitlis,Ahlat
18-24,1923,1896,3819,Kırklareli,Babaeski
25-29,1640,1412,3052,Kırklareli,Babaeski
30-34,1530,1270,2800,Kırklareli,Babaeski
35-39,1723,1635,3358,Kırklareli,Babaeski
40-44,1674,1573,3247,Kırklareli,Babaeski
45-49,1576,1642,3218,Kırklareli,Babaeski
50-54,1728,1849,3577,Kırklareli,Babaeski
55-59,1909,1907,3816,Kırklareli,Babaeski
60-64,1887,1920,3807,Kırklareli,Babaeski
65-69,1413,1497,2910,Kırklareli,Babaeski
70-74,908,1015,1923,Kırklareli,Babaeski
75+,1255,1905,3160,Kırklareli,Babaeski
18-24,3800,3923,7723,Antalya,Aksu
25-29,2730,2411,5141,Antalya,Aksu
30-34,2611,2443,5054,Antalya,Aksu
35-39,2920,2670,5590,Antalya,Aksu
40-44,2691,2422,5113,Antalya,Aksu
45-49,2504,2369,4873,Antalya,Aksu
50-54,2318,2126,4444,Antalya,Aksu
55-59,1913,1826,3739,Antalya,Aksu
60-64,1403,1307,2710,Antalya,Aksu
65-69,875,944,1819,Antalya,Aksu
70-74,544,597,1141,Antalya,Aksu
75+,648,966,1614,Antalya,Aksu
18-24,2435,2575,5010,Şanlıurfa,Halfeti
25-29,1293,1497,2790,Şanlıurfa,Halfeti
30-34,1232,1312,2544,Şanlıurfa,Halfeti
35-39,1072,1163,2235,Şanlıurfa,Halfeti
40-44,879,1041,1920,Şanlıurfa,Halfeti
45-49,800,810,1610,Şanlıurfa,Halfeti
50-54,782,762,1544,Şanlıurfa,Halfeti
55-59,602,718,1320,Şanlıurfa,Halfeti
60-64,523,639,1162,Şanlıurfa,Halfeti
65-69,478,593,1071,Şanlıurfa,Halfeti
70-74,327,483,810,Şanlıurfa,Halfeti
75+,597,950,1547,Şanlıurfa,Halfeti
18-24,723,773,1496,Malatya,Pütürge
25-29,450,398,848,Malatya,Pütürge
30-34,418,366,784,Malatya,Pütürge
35-39,395,414,809,Malatya,Pütürge
40-44,334,334,668,Malatya,Pütürge
45-49,304,345,649,Malatya,Pütürge
50-54,385,367,752,Malatya,Pütürge
55-59,405,400,805,Malatya,Pütürge
60-64,458,506,964,Malatya,Pütürge
65-69,422,548,970,Malatya,Pütürge
70-74,296,501,797,Malatya,Pütürge
75+,612,927,1539,Malatya,Pütürge
18-24,6899,7102,14001,Bartın,Bartın Merkez
25-29,4791,4734,9525,Bartın,Bartın Merkez
30-34,5413,5233,10646,Bartın,Bartın Merkez
35-39,5909,5943,11852,Bartın,Bartın Merkez
40-44,5625,5627,11252,Bartın,Bartın Merkez
45-49,5119,5248,10367,Bartın,Bartın Merkez
50-54,4518,4935,9453,Bartın,Bartın Merkez
55-59,4404,4852,9256,Bartın,Bartın Merkez
60-64,4057,4338,8395,Bartın,Bartın Merkez
65-69,3212,3391,6603,Bartın,Bartın Merkez
70-74,2121,2401,4522,Bartın,Bartın Merkez
75+,2654,3805,6459,Bartın,Bartın Merkez
18-24,7204,7430,14634,Muğla,Fethiye
25-29,5011,5151,10162,Muğla,Fethiye
30-34,5812,5776,11588,Muğla,Fethiye
35-39,6473,6632,13105,Muğla,Fethiye
40-44,6489,6408,12897,Muğla,Fethiye
45-49,6051,5794,11845,Muğla,Fethiye
50-54,5418,5123,10541,Muğla,Fethiye
55-59,4509,4300,8809,Muğla,Fethiye
60-64,3557,3338,6895,Muğla,Fethiye
65-69,2468,2499,4967,Muğla,Fethiye
70-74,1591,1748,3339,Muğla,Fethiye
75+,2255,2997,5252,Muğla,Fethiye
18-24,1478,1853,3331,Trabzon,Arsin
25-29,1043,1043,2086,Trabzon,Arsin
30-34,1040,893,1933,Trabzon,Arsin
35-39,958,900,1858,Trabzon,Arsin
40-44,868,775,1643,Trabzon,Arsin
45-49,844,825,1669,Trabzon,Arsin
50-54,963,927,1890,Trabzon,Arsin
55-59,889,831,1720,Trabzon,Arsin
60-64,766,795,1561,Trabzon,Arsin
65-69,515,555,1070,Trabzon,Arsin
70-74,346,439,785,Trabzon,Arsin
75+,529,963,1492,Trabzon,Arsin
18-24,1759,1695,3454,Mardin,Savur
25-29,868,837,1705,Mardin,Savur
30-34,729,723,1452,Mardin,Savur
35-39,784,811,1595,Mardin,Savur
40-44,636,699,1335,Mardin,Savur
45-49,695,619,1314,Mardin,Savur
50-54,512,487,999,Mardin,Savur
55-59,369,384,753,Mardin,Savur
60-64,321,379,700,Mardin,Savur
65-69,296,420,716,Mardin,Savur
70-74,231,311,542,Mardin,Savur
75+,535,744,1279,Mardin,Savur
18-24,1236,1224,2460,Çanakkale,Yenice
25-29,783,717,1500,Çanakkale,Yenice
30-34,888,840,1728,Çanakkale,Yenice
35-39,1024,962,1986,Çanakkale,Yenice
40-44,1033,930,1963,Çanakkale,Yenice
45-49,1148,1163,2311,Çanakkale,Yenice
50-54,1290,1239,2529,Çanakkale,Yenice
55-59,1284,1305,2589,Çanakkale,Yenice
60-64,1242,1325,2567,Çanakkale,Yenice
65-69,1048,1149,2197,Çanakkale,Yenice
70-74,702,857,1559,Çanakkale,Yenice
75+,1194,1777,2971,Çanakkale,Yenice
18-24,10411,11271,21682,Manisa,Yunusemre
25-29,8769,8915,17684,Manisa,Yunusemre
30-34,10060,10004,20064,Manisa,Yunusemre
35-39,10705,10398,21103,Manisa,Yunusemre
40-44,8794,8413,17207,Manisa,Yunusemre
45-49,7306,6913,14219,Manisa,Yunusemre
50-54,6301,6132,12433,Manisa,Yunusemre
55-59,5445,5454,10899,Manisa,Yunusemre
60-64,4393,4525,8918,Manisa,Yunusemre
65-69,3108,3233,6341,Manisa,Yunusemre
70-74,1857,2161,4018,Manisa,Yunusemre
75+,2082,3072,5154,Manisa,Yunusemre
18-24,157,179,336,Yozgat,Çandır
25-29,101,95,196,Yozgat,Çandır
30-34,126,94,220,Yozgat,Çandır
35-39,131,124,255,Yozgat,Çandır
40-44,127,108,235,Yozgat,Çandır
45-49,113,111,224,Yozgat,Çandır
50-54,140,133,273,Yozgat,Çandır
55-59,145,162,307,Yozgat,Çandır
60-64,164,183,347,Yozgat,Çandır
65-69,145,173,318,Yozgat,Çandır
70-74,121,133,254,Yozgat,Çandır
75+,160,261,421,Yozgat,Çandır
18-24,8419,8174,16593,İstanbul,Silivri
25-29,6756,6188,12944,İstanbul,Silivri
30-34,7120,6460,13580,İstanbul,Silivri
35-39,7487,6682,14169,İstanbul,Silivri
40-44,6461,5887,12348,İstanbul,Silivri
45-49,5556,5420,10976,İstanbul,Silivri
50-54,5038,4812,9850,İstanbul,Silivri
55-59,4472,4307,8779,İstanbul,Silivri
60-64,3591,3682,7273,İstanbul,Silivri
65-69,2720,2804,5524,İstanbul,Silivri
70-74,1724,2081,3805,İstanbul,Silivri
75+,2304,2850,5154,İstanbul,Silivri
18-24,1111,1155,2266,Çanakkale,Lapseki
25-29,812,748,1560,Çanakkale,Lapseki
30-34,831,742,1573,Çanakkale,Lapseki
35-39,929,886,1815,Çanakkale,Lapseki
40-44,965,813,1778,Çanakkale,Lapseki
45-49,893,917,1810,Çanakkale,Lapseki
50-54,884,980,1864,Çanakkale,Lapseki
55-59,961,986,1947,Çanakkale,Lapseki
60-64,908,1014,1922,Çanakkale,Lapseki
65-69,839,858,1697,Çanakkale,Lapseki
70-74,648,696,1344,Çanakkale,Lapseki
75+,815,1151,1966,Çanakkale,Lapseki
18-24,6725,6668,13393,Sakarya,Serdivan
25-29,5110,5258,10368,Sakarya,Serdivan
30-34,5086,5371,10457,Sakarya,Serdivan
35-39,5613,5468,11081,Sakarya,Serdivan
40-44,4733,4816,9549,Sakarya,Serdivan
45-49,4158,4063,8221,Sakarya,Serdivan
50-54,3570,3439,7009,Sakarya,Serdivan
55-59,3079,3065,6144,Sakarya,Serdivan
60-64,2590,2555,5145,Sakarya,Serdivan
65-69,1694,1745,3439,Sakarya,Serdivan
70-74,1086,1152,2238,Sakarya,Serdivan
75+,1113,1516,2629,Sakarya,Serdivan
18-24,3277,2906,6183,Ağrı,Diyadin
25-29,1803,1617,3420,Ağrı,Diyadin
30-34,1205,1002,2207,Ağrı,Diyadin
35-39,1290,1216,2506,Ağrı,Diyadin
40-44,963,853,1816,Ağrı,Diyadin
45-49,868,773,1641,Ağrı,Diyadin
50-54,749,590,1339,Ağrı,Diyadin
55-59,554,444,998,Ağrı,Diyadin
60-64,456,506,962,Ağrı,Diyadin
65-69,328,400,728,Ağrı,Diyadin
70-74,195,308,503,Ağrı,Diyadin
75+,235,365,600,Ağrı,Diyadin
18-24,746,612,1358,Konya,Doğanhisar
25-29,311,296,607,Konya,Doğanhisar
30-34,318,295,613,Konya,Doğanhisar
35-39,369,329,698,Konya,Doğanhisar
40-44,372,432,804,Konya,Doğanhisar
45-49,438,521,959,Konya,Doğanhisar
50-54,511,582,1093,Konya,Doğanhisar
55-59,636,740,1376,Konya,Doğanhisar
60-64,596,712,1308,Konya,Doğanhisar
65-69,596,726,1322,Konya,Doğanhisar
70-74,510,688,1198,Konya,Doğanhisar
75+,860,1059,1919,Konya,Doğanhisar
18-24,6739,7289,14028,Amasya,Amasya Merkez
25-29,4366,4705,9071,Amasya,Amasya Merkez
30-34,4903,5071,9974,Amasya,Amasya Merkez
35-39,5134,5333,10467,Amasya,Amasya Merkez
40-44,4788,4996,9784,Amasya,Amasya Merkez
45-49,4444,4666,9110,Amasya,Amasya Merkez
50-54,4334,4407,8741,Amasya,Amasya Merkez
55-59,4036,4215,8251,Amasya,Amasya Merkez
60-64,3397,3392,6789,Amasya,Amasya Merkez
65-69,2625,2812,5437,Amasya,Amasya Merkez
70-74,1902,2195,4097,Amasya,Amasya Merkez
75+,2411,3481,5892,Amasya,Amasya Merkez
18-24,4912,4686,9598,Van,Çaldıran
25-29,2814,2231,5045,Van,Çaldıran
30-34,1988,1761,3749,Van,Çaldıran
35-39,1298,1208,2506,Van,Çaldıran
40-44,1290,1201,2491,Van,Çaldıran
45-49,1138,1026,2164,Van,Çaldıran
50-54,924,861,1785,Van,Çaldıran
55-59,762,863,1625,Van,Çaldıran
60-64,575,652,1227,Van,Çaldıran
65-69,358,402,760,Van,Çaldıran
70-74,242,303,545,Van,Çaldıran
75+,259,420,679,Van,Çaldıran
18-24,536,400,936,Antalya,Akseki
25-29,377,279,656,Antalya,Akseki
30-34,274,197,471,Antalya,Akseki
35-39,252,228,480,Antalya,Akseki
40-44,269,238,507,Antalya,Akseki
45-49,274,335,609,Antalya,Akseki
50-54,340,390,730,Antalya,Akseki
55-59,396,446,842,Antalya,Akseki
60-64,443,442,885,Antalya,Akseki
65-69,339,429,768,Antalya,Akseki
70-74,360,393,753,Antalya,Akseki
75+,673,932,1605,Antalya,Akseki
18-24,351,370,721,Sakarya,Taraklı
25-29,225,212,437,Sakarya,Taraklı
30-34,229,194,423,Sakarya,Taraklı
35-39,224,217,441,Sakarya,Taraklı
40-44,193,202,395,Sakarya,Taraklı
45-49,239,223,462,Sakarya,Taraklı
50-54,203,191,394,Sakarya,Taraklı
55-59,213,202,415,Sakarya,Taraklı
60-64,185,179,364,Sakarya,Taraklı
65-69,164,187,351,Sakarya,Taraklı
70-74,112,124,236,Sakarya,Taraklı
75+,236,320,556,Sakarya,Taraklı
18-24,2348,2347,4695,Sakarya,Arifiye
25-29,1569,1521,3090,Sakarya,Arifiye
30-34,1609,1491,3100,Sakarya,Arifiye
35-39,1729,1670,3399,Sakarya,Arifiye
40-44,1516,1431,2947,Sakarya,Arifiye
45-49,1386,1364,2750,Sakarya,Arifiye
50-54,1231,1191,2422,Sakarya,Arifiye
55-59,1062,1023,2085,Sakarya,Arifiye
60-64,877,873,1750,Sakarya,Arifiye
65-69,586,610,1196,Sakarya,Arifiye
70-74,372,453,825,Sakarya,Arifiye
75+,477,740,1217,Sakarya,Arifiye
18-24,4252,4499,8751,Bursa,Gürsu
25-29,3468,3444,6912,Bursa,Gürsu
30-34,3768,3576,7344,Bursa,Gürsu
35-39,3726,3576,7302,Bursa,Gürsu
40-44,3085,2824,5909,Bursa,Gürsu
45-49,2673,2556,5229,Bursa,Gürsu
50-54,2302,2251,4553,Bursa,Gürsu
55-59,1960,1845,3805,Bursa,Gürsu
60-64,1436,1549,2985,Bursa,Gürsu
65-69,909,997,1906,Bursa,Gürsu
70-74,509,633,1142,Bursa,Gürsu
75+,677,1006,1683,Bursa,Gürsu
18-24,1247,1190,2437,Erzurum,Çat
25-29,690,550,1240,Erzurum,Çat
30-34,613,541,1154,Erzurum,Çat
35-39,608,565,1173,Erzurum,Çat
40-44,493,398,891,Erzurum,Çat
45-49,454,450,904,Erzurum,Çat
50-54,376,357,733,Erzurum,Çat
55-59,345,313,658,Erzurum,Çat
60-64,285,301,586,Erzurum,Çat
65-69,247,293,540,Erzurum,Çat
70-74,162,204,366,Erzurum,Çat
75+,183,255,438,Erzurum,Çat
18-24,1485,1490,2975,Denizli,Sarayköy
25-29,977,1010,1987,Denizli,Sarayköy
30-34,1079,1028,2107,Denizli,Sarayköy
35-39,1262,1150,2412,Denizli,Sarayköy
40-44,1146,1028,2174,Denizli,Sarayköy
45-49,963,946,1909,Denizli,Sarayköy
50-54,985,961,1946,Denizli,Sarayköy
55-59,941,997,1938,Denizli,Sarayköy
60-64,879,871,1750,Denizli,Sarayköy
65-69,647,741,1388,Denizli,Sarayköy
70-74,427,509,936,Denizli,Sarayköy
75+,580,927,1507,Denizli,Sarayköy
18-24,718,730,1448,Kayseri,Hacılar
25-29,403,341,744,Kayseri,Hacılar
30-34,409,411,820,Kayseri,Hacılar
35-39,450,438,888,Kayseri,Hacılar
40-44,449,418,867,Kayseri,Hacılar
45-49,431,396,827,Kayseri,Hacılar
50-54,349,355,704,Kayseri,Hacılar
55-59,312,325,637,Kayseri,Hacılar
60-64,334,275,609,Kayseri,Hacılar
65-69,217,253,470,Kayseri,Hacılar
70-74,149,217,366,Kayseri,Hacılar
75+,184,340,524,Kayseri,Hacılar
18-24,338,316,654,Konya,Taşkent
25-29,209,163,372,Konya,Taşkent
30-34,140,139,279,Konya,Taşkent
35-39,173,152,325,Konya,Taşkent
40-44,147,141,288,Konya,Taşkent
45-49,152,161,313,Konya,Taşkent
50-54,138,159,297,Konya,Taşkent
55-59,148,166,314,Konya,Taşkent
60-64,167,195,362,Konya,Taşkent
65-69,167,200,367,Konya,Taşkent
70-74,146,188,334,Konya,Taşkent
75+,258,349,607,Konya,Taşkent
18-24,2005,1734,3739,Tunceli,Tunceli Merkez
25-29,2476,1701,4177,Tunceli,Tunceli Merkez
30-34,1985,1576,3561,Tunceli,Tunceli Merkez
35-39,1649,1435,3084,Tunceli,Tunceli Merkez
40-44,1381,1043,2424,Tunceli,Tunceli Merkez
45-49,1143,1016,2159,Tunceli,Tunceli Merkez
50-54,928,857,1785,Tunceli,Tunceli Merkez
55-59,787,802,1589,Tunceli,Tunceli Merkez
60-64,685,745,1430,Tunceli,Tunceli Merkez
65-69,477,548,1025,Tunceli,Tunceli Merkez
70-74,302,362,664,Tunceli,Tunceli Merkez
75+,581,766,1347,Tunceli,Tunceli Merkez
18-24,8837,8770,17607,Gaziantep,Nizip
25-29,5182,5317,10499,Gaziantep,Nizip
30-34,4890,4822,9712,Gaziantep,Nizip
35-39,4520,4603,9123,Gaziantep,Nizip
40-44,4031,3965,7996,Gaziantep,Nizip
45-49,3491,3526,7017,Gaziantep,Nizip
50-54,3172,3125,6297,Gaziantep,Nizip
55-59,2330,2563,4893,Gaziantep,Nizip
60-64,1934,2058,3992,Gaziantep,Nizip
65-69,1704,1895,3599,Gaziantep,Nizip
70-74,1194,1530,2724,Gaziantep,Nizip
75+,1610,2552,4162,Gaziantep,Nizip
18-24,1036,1127,2163,Denizli,Kale
25-29,583,583,1166,Denizli,Kale
30-34,692,597,1289,Denizli,Kale
35-39,745,678,1423,Denizli,Kale
40-44,745,688,1433,Denizli,Kale
45-49,748,698,1446,Denizli,Kale
50-54,736,678,1414,Denizli,Kale
55-59,567,639,1206,Denizli,Kale
60-64,469,478,947,Denizli,Kale
65-69,371,488,859,Denizli,Kale
70-74,304,381,685,Denizli,Kale
75+,460,699,1159,Denizli,Kale
18-24,233,209,442,Kayseri,Felahiye
25-29,177,171,348,Kayseri,Felahiye
30-34,190,139,329,Kayseri,Felahiye
35-39,169,130,299,Kayseri,Felahiye
40-44,140,122,262,Kayseri,Felahiye
45-49,128,138,266,Kayseri,Felahiye
50-54,184,225,409,Kayseri,Felahiye
55-59,238,226,464,Kayseri,Felahiye
60-64,226,240,466,Kayseri,Felahiye
65-69,199,226,425,Kayseri,Felahiye
70-74,161,210,371,Kayseri,Felahiye
75+,221,317,538,Kayseri,Felahiye
18-24,2032,2156,4188,Kütahya,Gediz
25-29,1422,1508,2930,Kütahya,Gediz
30-34,1714,1723,3437,Kütahya,Gediz
35-39,1840,1720,3560,Kütahya,Gediz
40-44,1775,1689,3464,Kütahya,Gediz
45-49,1585,1687,3272,Kütahya,Gediz
50-54,1580,1815,3395,Kütahya,Gediz
55-59,1665,1859,3524,Kütahya,Gediz
60-64,1594,1604,3198,Kütahya,Gediz
65-69,1150,1324,2474,Kütahya,Gediz
70-74,781,995,1776,Kütahya,Gediz
75+,1352,1632,2984,Kütahya,Gediz
18-24,1604,1530,3134,Çorum,İskilip
25-29,833,773,1606,Çorum,İskilip
30-34,820,842,1662,Çorum,İskilip
35-39,882,908,1790,Çorum,İskilip
40-44,961,1041,2002,Çorum,İskilip
45-49,1017,1030,2047,Çorum,İskilip
50-54,1131,1058,2189,Çorum,İskilip
55-59,997,1185,2182,Çorum,İskilip
60-64,1032,1264,2296,Çorum,İskilip
65-69,860,1076,1936,Çorum,İskilip
70-74,733,934,1667,Çorum,İskilip
75+,1299,1626,2925,Çorum,İskilip
18-24,116,89,205,Karabük,Ovacık
25-29,92,58,150,Karabük,Ovacık
30-34,83,60,143,Karabük,Ovacık
35-39,79,61,140,Karabük,Ovacık
40-44,79,70,149,Karabük,Ovacık
45-49,75,64,139,Karabük,Ovacık
50-54,126,116,242,Karabük,Ovacık
55-59,140,139,279,Karabük,Ovacık
60-64,198,190,388,Karabük,Ovacık
65-69,170,179,349,Karabük,Ovacık
70-74,162,167,329,Karabük,Ovacık
75+,206,272,478,Karabük,Ovacık
18-24,748,799,1547,Tokat,Pazar
25-29,368,390,758,Tokat,Pazar
30-34,389,435,824,Tokat,Pazar
35-39,410,418,828,Tokat,Pazar
40-44,411,414,825,Tokat,Pazar
45-49,450,380,830,Tokat,Pazar
50-54,445,397,842,Tokat,Pazar
55-59,441,441,882,Tokat,Pazar
60-64,439,416,855,Tokat,Pazar
65-69,293,355,648,Tokat,Pazar
70-74,254,308,562,Tokat,Pazar
75+,282,430,712,Tokat,Pazar
18-24,21412,19769,41181,Eskişehir,Tepebaşı
25-29,14583,13609,28192,Eskişehir,Tepebaşı
30-34,13885,13226,27111,Eskişehir,Tepebaşı
35-39,13825,13673,27498,Eskişehir,Tepebaşı
40-44,12524,13120,25644,Eskişehir,Tepebaşı
45-49,11584,11913,23497,Eskişehir,Tepebaşı
50-54,10703,11491,22194,Eskişehir,Tepebaşı
55-59,10058,10411,20469,Eskişehir,Tepebaşı
60-64,7820,8176,15996,Eskişehir,Tepebaşı
65-69,5943,6534,12477,Eskişehir,Tepebaşı
70-74,3843,4837,8680,Eskişehir,Tepebaşı
75+,4988,7504,12492,Eskişehir,Tepebaşı
18-24,1484,1124,2608,Kırıkkale,Yahşihan
25-29,846,674,1520,Kırıkkale,Yahşihan
30-34,643,688,1331,Kırıkkale,Yahşihan
35-39,765,750,1515,Kırıkkale,Yahşihan
40-44,721,695,1416,Kırıkkale,Yahşihan
45-49,669,566,1235,Kırıkkale,Yahşihan
50-54,525,493,1018,Kırıkkale,Yahşihan
55-59,465,380,845,Kırıkkale,Yahşihan
60-64,312,355,667,Kırıkkale,Yahşihan
65-69,284,311,595,Kırıkkale,Yahşihan
70-74,171,171,342,Kırıkkale,Yahşihan
75+,224,307,531,Kırıkkale,Yahşihan
18-24,6914,7271,14185,Adana,Kozan
25-29,3745,3967,7712,Adana,Kozan
30-34,4205,4290,8495,Adana,Kozan
35-39,4805,4607,9412,Adana,Kozan
40-44,4686,4690,9376,Adana,Kozan
45-49,4481,4590,9071,Adana,Kozan
50-54,4185,4126,8311,Adana,Kozan
55-59,3666,3451,7117,Adana,Kozan
60-64,2916,2849,5765,Adana,Kozan
65-69,2248,2378,4626,Adana,Kozan
70-74,1469,1851,3320,Adana,Kozan
75+,2035,2890,4925,Adana,Kozan
18-24,815,831,1646,Bartın,Ulus
25-29,533,462,995,Bartın,Ulus
30-34,465,414,879,Bartın,Ulus
35-39,534,493,1027,Bartın,Ulus
40-44,487,543,1030,Bartın,Ulus
45-49,633,693,1326,Bartın,Ulus
50-54,767,878,1645,Bartın,Ulus
55-59,875,934,1809,Bartın,Ulus
60-64,1074,1127,2201,Bartın,Ulus
65-69,906,990,1896,Bartın,Ulus
70-74,629,712,1341,Bartın,Ulus
75+,914,1054,1968,Bartın,Ulus
18-24,863,637,1500,Gümüşhane,Kürtün
25-29,515,358,873,Gümüşhane,Kürtün
30-34,442,354,796,Gümüşhane,Kürtün
35-39,395,358,753,Gümüşhane,Kürtün
40-44,384,311,695,Gümüşhane,Kürtün
45-49,404,362,766,Gümüşhane,Kürtün
50-54,422,370,792,Gümüşhane,Kürtün
55-59,388,387,775,Gümüşhane,Kürtün
60-64,371,386,757,Gümüşhane,Kürtün
65-69,284,320,604,Gümüşhane,Kürtün
70-74,174,242,416,Gümüşhane,Kürtün
75+,300,524,824,Gümüşhane,Kürtün
18-24,928,977,1905,Adana,Yumurtalık
25-29,556,495,1051,Adana,Yumurtalık
30-34,548,522,1070,Adana,Yumurtalık
35-39,545,500,1045,Adana,Yumurtalık
40-44,589,528,1117,Adana,Yumurtalık
45-49,616,634,1250,Adana,Yumurtalık
50-54,676,641,1317,Adana,Yumurtalık
55-59,656,590,1246,Adana,Yumurtalık
60-64,514,503,1017,Adana,Yumurtalık
65-69,370,404,774,Adana,Yumurtalık
70-74,227,299,526,Adana,Yumurtalık
75+,289,501,790,Adana,Yumurtalık
18-24,2133,2002,4135,Denizli,Tavas
25-29,1184,1092,2276,Denizli,Tavas
30-34,1263,1118,2381,Denizli,Tavas
35-39,1493,1353,2846,Denizli,Tavas
40-44,1558,1452,3010,Denizli,Tavas
45-49,1539,1490,3029,Denizli,Tavas
50-54,1615,1550,3165,Denizli,Tavas
55-59,1521,1619,3140,Denizli,Tavas
60-64,1380,1548,2928,Denizli,Tavas
65-69,1225,1467,2692,Denizli,Tavas
70-74,838,1276,2114,Denizli,Tavas
75+,1368,2266,3634,Denizli,Tavas
18-24,278,226,504,Bartın,Kurucaşile
25-29,172,143,315,Bartın,Kurucaşile
30-34,223,179,402,Bartın,Kurucaşile
35-39,212,184,396,Bartın,Kurucaşile
40-44,179,154,333,Bartın,Kurucaşile
45-49,197,184,381,Bartın,Kurucaşile
50-54,207,208,415,Bartın,Kurucaşile
55-59,245,260,505,Bartın,Kurucaşile
60-64,270,301,571,Bartın,Kurucaşile
65-69,250,248,498,Bartın,Kurucaşile
70-74,155,191,346,Bartın,Kurucaşile
75+,266,403,669,Bartın,Kurucaşile
18-24,801,868,1669,Kayseri,Yeşilhisar
25-29,457,449,906,Kayseri,Yeşilhisar
30-34,505,473,978,Kayseri,Yeşilhisar
35-39,481,429,910,Kayseri,Yeşilhisar
40-44,438,453,891,Kayseri,Yeşilhisar
45-49,484,535,1019,Kayseri,Yeşilhisar
50-54,544,525,1069,Kayseri,Yeşilhisar
55-59,561,554,1115,Kayseri,Yeşilhisar
60-64,466,482,948,Kayseri,Yeşilhisar
65-69,381,401,782,Kayseri,Yeşilhisar
70-74,321,441,762,Kayseri,Yeşilhisar
75+,465,703,1168,Kayseri,Yeşilhisar
18-24,2031,1920,3951,Muş,Varto
25-29,1167,1075,2242,Muş,Varto
30-34,919,873,1792,Muş,Varto
35-39,997,970,1967,Muş,Varto
40-44,746,782,1528,Muş,Varto
45-49,724,726,1450,Muş,Varto
50-54,705,650,1355,Muş,Varto
55-59,642,576,1218,Muş,Varto
60-64,677,745,1422,Muş,Varto
65-69,493,671,1164,Muş,Varto
70-74,381,449,830,Muş,Varto
75+,495,733,1228,Muş,Varto
18-24,674,600,1274,Sivas,Altınyayla
25-29,378,300,678,Sivas,Altınyayla
30-34,307,256,563,Sivas,Altınyayla
35-39,348,283,631,Sivas,Altınyayla
40-44,279,276,555,Sivas,Altınyayla
45-49,262,236,498,Sivas,Altınyayla
50-54,237,224,461,Sivas,Altınyayla
55-59,229,236,465,Sivas,Altınyayla
60-64,208,223,431,Sivas,Altınyayla
65-69,185,191,376,Sivas,Altınyayla
70-74,106,158,264,Sivas,Altınyayla
75+,149,209,358,Sivas,Altınyayla
18-24,75,68,143,Eskişehir,Han
25-29,52,42,94,Eskişehir,Han
30-34,47,27,74,Eskişehir,Han
35-39,43,29,72,Eskişehir,Han
40-44,52,49,101,Eskişehir,Han
45-49,69,68,137,Eskişehir,Han
50-54,92,74,166,Eskişehir,Han
55-59,90,79,169,Eskişehir,Han
60-64,73,80,153,Eskişehir,Han
65-69,81,94,175,Eskişehir,Han
70-74,79,83,162,Eskişehir,Han
75+,134,159,293,Eskişehir,Han
18-24,102,72,174,Isparta,Yenişarbademli
25-29,67,43,110,Isparta,Yenişarbademli
30-34,58,32,90,Isparta,Yenişarbademli
35-39,35,30,65,Isparta,Yenişarbademli
40-44,46,42,88,Isparta,Yenişarbademli
45-49,49,69,118,Isparta,Yenişarbademli
50-54,71,96,167,Isparta,Yenişarbademli
55-59,91,100,191,Isparta,Yenişarbademli
60-64,93,136,229,Isparta,Yenişarbademli
65-69,95,97,192,Isparta,Yenişarbademli
70-74,52,71,123,Isparta,Yenişarbademli
75+,106,116,222,Isparta,Yenişarbademli
18-24,10650,11097,21747,Kocaeli,Darıca
25-29,8510,8890,17400,Kocaeli,Darıca
30-34,9256,9221,18477,Kocaeli,Darıca
35-39,9815,9086,18901,Kocaeli,Darıca
40-44,8067,7199,15266,Kocaeli,Darıca
45-49,6353,5940,12293,Kocaeli,Darıca
50-54,5318,4886,10204,Kocaeli,Darıca
55-59,4132,3840,7972,Kocaeli,Darıca
60-64,2974,3035,6009,Kocaeli,Darıca
65-69,1969,2122,4091,Kocaeli,Darıca
70-74,1269,1469,2738,Kocaeli,Darıca
75+,1371,1998,3369,Kocaeli,Darıca
18-24,295,244,539,Sivas,İmranlı
25-29,190,140,330,Sivas,İmranlı
30-34,194,144,338,Sivas,İmranlı
35-39,202,158,360,Sivas,İmranlı
40-44,222,161,383,Sivas,İmranlı
45-49,215,179,394,Sivas,İmranlı
50-54,247,229,476,Sivas,İmranlı
55-59,322,346,668,Sivas,İmranlı
60-64,384,395,779,Sivas,İmranlı
65-69,395,406,801,Sivas,İmranlı
70-74,372,364,736,Sivas,İmranlı
75+,455,565,1020,Sivas,İmranlı
18-24,21125,21924,43049,Sivas,Sivas Merkez
25-29,13561,14195,27756,Sivas,Sivas Merkez
30-34,13604,13802,27406,Sivas,Sivas Merkez
35-39,13487,13800,27287,Sivas,Sivas Merkez
40-44,11844,12144,23988,Sivas,Sivas Merkez
45-49,10611,11059,21670,Sivas,Sivas Merkez
50-54,9631,9771,19402,Sivas,Sivas Merkez
55-59,8481,8579,17060,Sivas,Sivas Merkez
60-64,6981,6968,13949,Sivas,Sivas Merkez
65-69,5378,5678,11056,Sivas,Sivas Merkez
70-74,3479,4042,7521,Sivas,Sivas Merkez
75+,4319,5902,10221,Sivas,Sivas Merkez
18-24,1298,1309,2607,Kayseri,Tomarza
25-29,749,612,1361,Kayseri,Tomarza
30-34,772,654,1426,Kayseri,Tomarza
35-39,754,612,1366,Kayseri,Tomarza
40-44,696,643,1339,Kayseri,Tomarza
45-49,628,659,1287,Kayseri,Tomarza
50-54,701,633,1334,Kayseri,Tomarza
55-59,729,668,1397,Kayseri,Tomarza
60-64,608,632,1240,Kayseri,Tomarza
65-69,487,576,1063,Kayseri,Tomarza
70-74,350,514,864,Kayseri,Tomarza
75+,530,829,1359,Kayseri,Tomarza
18-24,616,647,1263,Gümüşhane,Torul
25-29,404,348,752,Gümüşhane,Torul
30-34,406,283,689,Gümüşhane,Torul
35-39,323,273,596,Gümüşhane,Torul
40-44,334,296,630,Gümüşhane,Torul
45-49,320,321,641,Gümüşhane,Torul
50-54,411,368,779,Gümüşhane,Torul
55-59,368,355,723,Gümüşhane,Torul
60-64,376,440,816,Gümüşhane,Torul
65-69,292,294,586,Gümüşhane,Torul
70-74,195,278,473,Gümüşhane,Torul
75+,293,504,797,Gümüşhane,Torul
18-24,706,674,1380,Erzincan,Üzümlü
25-29,422,372,794,Erzincan,Üzümlü
30-34,462,379,841,Erzincan,Üzümlü
35-39,419,343,762,Erzincan,Üzümlü
40-44,374,351,725,Erzincan,Üzümlü
45-49,383,382,765,Erzincan,Üzümlü
50-54,444,380,824,Erzincan,Üzümlü
55-59,378,388,766,Erzincan,Üzümlü
60-64,346,379,725,Erzincan,Üzümlü
65-69,297,318,615,Erzincan,Üzümlü
70-74,205,233,438,Erzincan,Üzümlü
75+,295,430,725,Erzincan,Üzümlü
18-24,6992,7784,14776,Samsun,Bafra
25-29,4404,4403,8807,Samsun,Bafra
30-34,4355,4469,8824,Samsun,Bafra
35-39,4716,5169,9885,Samsun,Bafra
40-44,4666,4925,9591,Samsun,Bafra
45-49,4686,5134,9820,Samsun,Bafra
50-54,5238,5341,10579,Samsun,Bafra
55-59,4656,4787,9443,Samsun,Bafra
60-64,4011,4158,8169,Samsun,Bafra
65-69,3236,3430,6666,Samsun,Bafra
70-74,2174,2516,4690,Samsun,Bafra
75+,3027,4538,7565,Samsun,Bafra
18-24,495,467,962,Ardahan,Hanak
25-29,267,222,489,Ardahan,Hanak
30-34,269,226,495,Ardahan,Hanak
35-39,300,259,559,Ardahan,Hanak
40-44,289,278,567,Ardahan,Hanak
45-49,307,270,577,Ardahan,Hanak
50-54,282,256,538,Ardahan,Hanak
55-59,319,283,602,Ardahan,Hanak
60-64,301,300,601,Ardahan,Hanak
65-69,249,272,521,Ardahan,Hanak
70-74,195,219,414,Ardahan,Hanak
75+,281,375,656,Ardahan,Hanak
18-24,1382,1246,2628,Mersin,Gülnar
25-29,738,662,1400,Mersin,Gülnar
30-34,727,620,1347,Mersin,Gülnar
35-39,781,686,1467,Mersin,Gülnar
40-44,800,808,1608,Mersin,Gülnar
45-49,873,904,1777,Mersin,Gülnar
50-54,885,913,1798,Mersin,Gülnar
55-59,801,820,1621,Mersin,Gülnar
60-64,747,817,1564,Mersin,Gülnar
65-69,563,671,1234,Mersin,Gülnar
70-74,515,671,1186,Mersin,Gülnar
75+,904,1154,2058,Mersin,Gülnar
18-24,2300,2278,4578,Ağrı,Eleşkirt
25-29,1395,1229,2624,Ağrı,Eleşkirt
30-34,1086,896,1982,Ağrı,Eleşkirt
35-39,1160,1101,2261,Ağrı,Eleşkirt
40-44,796,817,1613,Ağrı,Eleşkirt
45-49,762,680,1442,Ağrı,Eleşkirt
50-54,692,663,1355,Ağrı,Eleşkirt
55-59,553,572,1125,Ağrı,Eleşkirt
60-64,426,510,936,Ağrı,Eleşkirt
65-69,332,395,727,Ağrı,Eleşkirt
70-74,266,281,547,Ağrı,Eleşkirt
75+,366,454,820,Ağrı,Eleşkirt
18-24,824,809,1633,Ordu,Çaybaşı
25-29,387,349,736,Ordu,Çaybaşı
30-34,383,363,746,Ordu,Çaybaşı
35-39,445,401,846,Ordu,Çaybaşı
40-44,459,408,867,Ordu,Çaybaşı
45-49,369,345,714,Ordu,Çaybaşı
50-54,419,440,859,Ordu,Çaybaşı
55-59,372,333,705,Ordu,Çaybaşı
60-64,361,338,699,Ordu,Çaybaşı
65-69,298,296,594,Ordu,Çaybaşı
70-74,202,242,444,Ordu,Çaybaşı
75+,288,406,694,Ordu,Çaybaşı
18-24,768,731,1499,Edirne,Havsa
25-29,517,422,939,Edirne,Havsa
30-34,484,422,906,Edirne,Havsa
35-39,577,529,1106,Edirne,Havsa
40-44,574,602,1176,Edirne,Havsa
45-49,677,655,1332,Edirne,Havsa
50-54,785,786,1571,Edirne,Havsa
55-59,905,910,1815,Edirne,Havsa
60-64,879,879,1758,Edirne,Havsa
65-69,629,633,1262,Edirne,Havsa
70-74,367,464,831,Edirne,Havsa
75+,655,965,1620,Edirne,Havsa
18-24,1848,1807,3655,Muş,Korkut
25-29,1093,993,2086,Muş,Korkut
30-34,680,684,1364,Muş,Korkut
35-39,694,714,1408,Muş,Korkut
40-44,574,569,1143,Muş,Korkut
45-49,456,411,867,Muş,Korkut
50-54,473,404,877,Muş,Korkut
55-59,385,303,688,Muş,Korkut
60-64,358,337,695,Muş,Korkut
65-69,200,273,473,Muş,Korkut
70-74,137,181,318,Muş,Korkut
75+,139,251,390,Muş,Korkut
18-24,3519,3652,7171,Diyarbakır,Çermik
25-29,2243,2106,4349,Diyarbakır,Çermik
30-34,1804,1590,3394,Diyarbakır,Çermik
35-39,1660,1597,3257,Diyarbakır,Çermik
40-44,1297,1305,2602,Diyarbakır,Çermik
45-49,1092,1014,2106,Diyarbakır,Çermik
50-54,947,880,1827,Diyarbakır,Çermik
55-59,696,792,1488,Diyarbakır,Çermik
60-64,578,655,1233,Diyarbakır,Çermik
65-69,495,651,1146,Diyarbakır,Çermik
70-74,339,414,753,Diyarbakır,Çermik
75+,509,759,1268,Diyarbakır,Çermik
18-24,44709,45292,90001,İstanbul,Bağcılar
25-29,31886,30861,62747,İstanbul,Bağcılar
30-34,32836,31637,64473,İstanbul,Bağcılar
35-39,34816,33200,68016,İstanbul,Bağcılar
40-44,29437,27809,57246,İstanbul,Bağcılar
45-49,25403,22987,48390,İstanbul,Bağcılar
50-54,20172,18125,38297,İstanbul,Bağcılar
55-59,14493,13315,27808,İstanbul,Bağcılar
60-64,9599,9963,19562,İstanbul,Bağcılar
65-69,5928,6901,12829,İstanbul,Bağcılar
70-74,3438,4291,7729,İstanbul,Bağcılar
75+,3399,5594,8993,İstanbul,Bağcılar
18-24,1376,1325,2701,Çanakkale,Ezine
25-29,914,839,1753,Çanakkale,Ezine
30-34,917,879,1796,Çanakkale,Ezine
35-39,1070,1043,2113,Çanakkale,Ezine
40-44,1029,1035,2064,Çanakkale,Ezine
45-49,1051,1069,2120,Çanakkale,Ezine
50-54,1144,1127,2271,Çanakkale,Ezine
55-59,1121,1145,2266,Çanakkale,Ezine
60-64,1040,1085,2125,Çanakkale,Ezine
65-69,954,994,1948,Çanakkale,Ezine
70-74,707,824,1531,Çanakkale,Ezine
75+,945,1283,2228,Çanakkale,Ezine
18-24,887,964,1851,Amasya,Gümüşhacıköy
25-29,621,585,1206,Amasya,Gümüşhacıköy
30-34,605,570,1175,Amasya,Gümüşhacıköy
35-39,645,591,1236,Amasya,Gümüşhacıköy
40-44,613,652,1265,Amasya,Gümüşhacıköy
45-49,657,690,1347,Amasya,Gümüşhacıköy
50-54,762,778,1540,Amasya,Gümüşhacıköy
55-59,902,1022,1924,Amasya,Gümüşhacıköy
60-64,747,943,1690,Amasya,Gümüşhacıköy
65-69,766,841,1607,Amasya,Gümüşhacıköy
70-74,618,784,1402,Amasya,Gümüşhacıköy
75+,1045,1411,2456,Amasya,Gümüşhacıköy
18-24,506,284,790,Siirt,Tillo
25-29,183,152,335,Siirt,Tillo
30-34,142,120,262,Siirt,Tillo
35-39,119,110,229,Siirt,Tillo
40-44,73,96,169,Siirt,Tillo
45-49,82,78,160,Siirt,Tillo
50-54,77,58,135,Siirt,Tillo
55-59,46,60,106,Siirt,Tillo
60-64,45,45,90,Siirt,Tillo
65-69,49,58,107,Siirt,Tillo
70-74,33,33,66,Siirt,Tillo
75+,50,80,130,Siirt,Tillo
18-24,1075,1063,2138,Bilecik,Osmaneli
25-29,719,716,1435,Bilecik,Osmaneli
30-34,777,706,1483,Bilecik,Osmaneli
35-39,803,798,1601,Bilecik,Osmaneli
40-44,748,713,1461,Bilecik,Osmaneli
45-49,741,722,1463,Bilecik,Osmaneli
50-54,714,702,1416,Bilecik,Osmaneli
55-59,664,695,1359,Bilecik,Osmaneli
60-64,616,588,1204,Bilecik,Osmaneli
65-69,396,457,853,Bilecik,Osmaneli
70-74,227,304,531,Bilecik,Osmaneli
75+,410,541,951,Bilecik,Osmaneli
18-24,47013,48415,95428,İstanbul,Esenyurt
25-29,40089,40979,81068,İstanbul,Esenyurt
30-34,44234,40334,84568,İstanbul,Esenyurt
35-39,43041,37707,80748,İstanbul,Esenyurt
40-44,31382,27815,59197,İstanbul,Esenyurt
45-49,23910,21887,45797,İstanbul,Esenyurt
50-54,18306,16860,35166,İstanbul,Esenyurt
55-59,13290,12374,25664,İstanbul,Esenyurt
60-64,8706,8938,17644,İstanbul,Esenyurt
65-69,5077,5801,10878,İstanbul,Esenyurt
70-74,2836,3397,6233,İstanbul,Esenyurt
75+,2571,4486,7057,İstanbul,Esenyurt
18-24,12953,13301,26254,Kahramanmaraş,Dulkadiroğlu
25-29,8119,8115,16234,Kahramanmaraş,Dulkadiroğlu
30-34,8531,7975,16506,Kahramanmaraş,Dulkadiroğlu
35-39,8476,8081,16557,Kahramanmaraş,Dulkadiroğlu
40-44,6877,6721,13598,Kahramanmaraş,Dulkadiroğlu
45-49,5965,5941,11906,Kahramanmaraş,Dulkadiroğlu
50-54,4993,4679,9672,Kahramanmaraş,Dulkadiroğlu
55-59,4272,4148,8420,Kahramanmaraş,Dulkadiroğlu
60-64,3394,3414,6808,Kahramanmaraş,Dulkadiroğlu
65-69,2603,2691,5294,Kahramanmaraş,Dulkadiroğlu
70-74,1886,1834,3720,Kahramanmaraş,Dulkadiroğlu
75+,2436,3073,5509,Kahramanmaraş,Dulkadiroğlu
18-24,364,239,603,Ardahan,Damal
25-29,290,155,445,Ardahan,Damal
30-34,274,138,412,Ardahan,Damal
35-39,278,159,437,Ardahan,Damal
40-44,259,177,436,Ardahan,Damal
45-49,233,162,395,Ardahan,Damal
50-54,195,154,349,Ardahan,Damal
55-59,211,177,388,Ardahan,Damal
60-64,170,156,326,Ardahan,Damal
65-69,148,217,365,Ardahan,Damal
70-74,116,136,252,Ardahan,Damal
75+,114,196,310,Ardahan,Damal
18-24,1307,1388,2695,Aydın,Köşk
25-29,818,830,1648,Aydın,Köşk
30-34,947,931,1878,Aydın,Köşk
35-39,1043,1005,2048,Aydın,Köşk
40-44,940,966,1906,Aydın,Köşk
45-49,1027,869,1896,Aydın,Köşk
50-54,923,858,1781,Aydın,Köşk
55-59,896,827,1723,Aydın,Köşk
60-64,680,689,1369,Aydın,Köşk
65-69,490,540,1030,Aydın,Köşk
70-74,365,454,819,Aydın,Köşk
75+,614,779,1393,Aydın,Köşk
18-24,156,172,328,Trabzon,Dernekpazarı
25-29,96,77,173,Trabzon,Dernekpazarı
30-34,85,72,157,Trabzon,Dernekpazarı
35-39,73,72,145,Trabzon,Dernekpazarı
40-44,90,82,172,Trabzon,Dernekpazarı
45-49,111,125,236,Trabzon,Dernekpazarı
50-54,123,139,262,Trabzon,Dernekpazarı
55-59,177,168,345,Trabzon,Dernekpazarı
60-64,179,187,366,Trabzon,Dernekpazarı
65-69,176,185,361,Trabzon,Dernekpazarı
70-74,138,142,280,Trabzon,Dernekpazarı
75+,204,303,507,Trabzon,Dernekpazarı
18-24,833,780,1613,Düzce,Cumayeri
25-29,539,507,1046,Düzce,Cumayeri
30-34,508,494,1002,Düzce,Cumayeri
35-39,559,510,1069,Düzce,Cumayeri
40-44,533,453,986,Düzce,Cumayeri
45-49,425,483,908,Düzce,Cumayeri
50-54,473,443,916,Düzce,Cumayeri
55-59,418,394,812,Düzce,Cumayeri
60-64,368,349,717,Düzce,Cumayeri
65-69,228,260,488,Düzce,Cumayeri
70-74,172,202,374,Düzce,Cumayeri
75+,199,305,504,Düzce,Cumayeri
18-24,253,257,510,Eskişehir,Beylikova
25-29,179,143,322,Eskişehir,Beylikova
30-34,178,140,318,Eskişehir,Beylikova
35-39,181,156,337,Eskişehir,Beylikova
40-44,203,200,403,Eskişehir,Beylikova
45-49,236,218,454,Eskişehir,Beylikova
50-54,262,208,470,Eskişehir,Beylikova
55-59,278,251,529,Eskişehir,Beylikova
60-64,207,223,430,Eskişehir,Beylikova
65-69,201,221,422,Eskişehir,Beylikova
70-74,162,175,337,Eskişehir,Beylikova
75+,210,353,563,Eskişehir,Beylikova
18-24,1489,1546,3035,Ardahan,Göle
25-29,839,770,1609,Ardahan,Göle
30-34,765,687,1452,Ardahan,Göle
35-39,898,765,1663,Ardahan,Göle
40-44,914,780,1694,Ardahan,Göle
45-49,757,650,1407,Ardahan,Göle
50-54,749,674,1423,Ardahan,Göle
55-59,580,545,1125,Ardahan,Göle
60-64,604,575,1179,Ardahan,Göle
65-69,511,570,1081,Ardahan,Göle
70-74,436,501,937,Ardahan,Göle
75+,594,754,1348,Ardahan,Göle
18-24,3227,3308,6535,Sakarya,Karasu
25-29,2195,2090,4285,Sakarya,Karasu
30-34,2097,2102,4199,Sakarya,Karasu
35-39,2340,2258,4598,Sakarya,Karasu
40-44,2135,2164,4299,Sakarya,Karasu
45-49,2036,2058,4094,Sakarya,Karasu
50-54,2086,2135,4221,Sakarya,Karasu
55-59,2043,1947,3990,Sakarya,Karasu
60-64,1738,1778,3516,Sakarya,Karasu
65-69,1315,1266,2581,Sakarya,Karasu
70-74,856,940,1796,Sakarya,Karasu
75+,961,1372,2333,Sakarya,Karasu
18-24,6096,6556,12652,Ordu,Fatsa
25-29,3790,4098,7888,Ordu,Fatsa
30-34,4079,4097,8176,Ordu,Fatsa
35-39,4341,4716,9057,Ordu,Fatsa
40-44,4182,4162,8344,Ordu,Fatsa
45-49,3743,3512,7255,Ordu,Fatsa
50-54,3752,3596,7348,Ordu,Fatsa
55-59,3257,3131,6388,Ordu,Fatsa
60-64,2859,2947,5806,Ordu,Fatsa
65-69,2189,2252,4441,Ordu,Fatsa
70-74,1458,1739,3197,Ordu,Fatsa
75+,2118,2991,5109,Ordu,Fatsa
18-24,2830,940,3770,Hakkari,Çukurca
25-29,2514,488,3002,Hakkari,Çukurca
30-34,563,302,865,Hakkari,Çukurca
35-39,430,350,780,Hakkari,Çukurca
40-44,364,223,587,Hakkari,Çukurca
45-49,254,178,432,Hakkari,Çukurca
50-54,171,176,347,Hakkari,Çukurca
55-59,119,130,249,Hakkari,Çukurca
60-64,87,138,225,Hakkari,Çukurca
65-69,65,94,159,Hakkari,Çukurca
70-74,53,64,117,Hakkari,Çukurca
75+,75,121,196,Hakkari,Çukurca
18-24,871,905,1776,Osmaniye,Sumbas
25-29,417,325,742,Osmaniye,Sumbas
30-34,407,356,763,Osmaniye,Sumbas
35-39,481,412,893,Osmaniye,Sumbas
40-44,464,484,948,Osmaniye,Sumbas
45-49,552,543,1095,Osmaniye,Sumbas
50-54,528,475,1003,Osmaniye,Sumbas
55-59,462,437,899,Osmaniye,Sumbas
60-64,350,361,711,Osmaniye,Sumbas
65-69,270,310,580,Osmaniye,Sumbas
70-74,212,293,505,Osmaniye,Sumbas
75+,296,467,763,Osmaniye,Sumbas
18-24,1595,1253,2848,Şırnak,Beytüşşebap
25-29,1417,642,2059,Şırnak,Beytüşşebap
30-34,588,427,1015,Şırnak,Beytüşşebap
35-39,548,576,1124,Şırnak,Beytüşşebap
40-44,353,339,692,Şırnak,Beytüşşebap
45-49,414,293,707,Şırnak,Beytüşşebap
50-54,279,231,510,Şırnak,Beytüşşebap
55-59,185,163,348,Şırnak,Beytüşşebap
60-64,138,156,294,Şırnak,Beytüşşebap
65-69,134,181,315,Şırnak,Beytüşşebap
70-74,102,104,206,Şırnak,Beytüşşebap
75+,121,196,317,Şırnak,Beytüşşebap
18-24,2119,2090,4209,Bitlis,Adilcevaz
25-29,1263,1215,2478,Bitlis,Adilcevaz
30-34,977,897,1874,Bitlis,Adilcevaz
35-39,877,839,1716,Bitlis,Adilcevaz
40-44,697,667,1364,Bitlis,Adilcevaz
45-49,710,632,1342,Bitlis,Adilcevaz
50-54,629,515,1144,Bitlis,Adilcevaz
55-59,511,491,1002,Bitlis,Adilcevaz
60-64,450,447,897,Bitlis,Adilcevaz
65-69,260,300,560,Bitlis,Adilcevaz
70-74,162,226,388,Bitlis,Adilcevaz
75+,306,393,699,Bitlis,Adilcevaz
18-24,1494,1401,2895,Ankara,Haymana
25-29,913,698,1611,Ankara,Haymana
30-34,896,676,1572,Ankara,Haymana
35-39,911,789,1700,Ankara,Haymana
40-44,886,742,1628,Ankara,Haymana
45-49,890,856,1746,Ankara,Haymana
50-54,1016,930,1946,Ankara,Haymana
55-59,1049,1046,2095,Ankara,Haymana
60-64,851,943,1794,Ankara,Haymana
65-69,819,798,1617,Ankara,Haymana
70-74,492,603,1095,Ankara,Haymana
75+,636,864,1500,Ankara,Haymana
18-24,7367,7631,14998,Mardin,Midyat
25-29,4484,4489,8973,Mardin,Midyat
30-34,3746,3672,7418,Mardin,Midyat
35-39,3417,3591,7008,Mardin,Midyat
40-44,2749,2953,5702,Mardin,Midyat
45-49,2304,2315,4619,Mardin,Midyat
50-54,1901,1877,3778,Mardin,Midyat
55-59,1453,1378,2831,Mardin,Midyat
60-64,1166,1354,2520,Mardin,Midyat
65-69,998,1253,2251,Mardin,Midyat
70-74,789,1027,1816,Mardin,Midyat
75+,1434,2041,3475,Mardin,Midyat
18-24,7299,7786,15085,Mersin,Erdemli
25-29,4211,4374,8585,Mersin,Erdemli
30-34,4476,4515,8991,Mersin,Erdemli
35-39,5091,5328,10419,Mersin,Erdemli
40-44,5273,5205,10478,Mersin,Erdemli
45-49,5065,4999,10064,Mersin,Erdemli
50-54,4716,4680,9396,Mersin,Erdemli
55-59,3996,4085,8081,Mersin,Erdemli
60-64,3307,3241,6548,Mersin,Erdemli
65-69,2265,2406,4671,Mersin,Erdemli
70-74,1526,1790,3316,Mersin,Erdemli
75+,2159,2652,4811,Mersin,Erdemli
18-24,839,870,1709,Karabük,Yenice
25-29,578,508,1086,Karabük,Yenice
30-34,550,464,1014,Karabük,Yenice
35-39,596,570,1166,Karabük,Yenice
40-44,548,538,1086,Karabük,Yenice
45-49,662,745,1407,Karabük,Yenice
50-54,765,929,1694,Karabük,Yenice
55-59,876,953,1829,Karabük,Yenice
60-64,798,854,1652,Karabük,Yenice
65-69,677,739,1416,Karabük,Yenice
70-74,564,573,1137,Karabük,Yenice
75+,610,824,1434,Karabük,Yenice
18-24,928,930,1858,Iğdır,Karakoyunlu
25-29,578,449,1027,Iğdır,Karakoyunlu
30-34,464,423,887,Iğdır,Karakoyunlu
35-39,512,406,918,Iğdır,Karakoyunlu
40-44,398,345,743,Iğdır,Karakoyunlu
45-49,367,347,714,Iğdır,Karakoyunlu
50-54,312,307,619,Iğdır,Karakoyunlu
55-59,310,319,629,Iğdır,Karakoyunlu
60-64,269,263,532,Iğdır,Karakoyunlu
65-69,187,199,386,Iğdır,Karakoyunlu
70-74,130,143,273,Iğdır,Karakoyunlu
75+,161,248,409,Iğdır,Karakoyunlu
18-24,12359,11695,24054,İstanbul,Şişli
25-29,11678,11731,23409,İstanbul,Şişli
30-34,11973,11589,23562,İstanbul,Şişli
35-39,11652,12035,23687,İstanbul,Şişli
40-44,10225,10928,21153,İstanbul,Şişli
45-49,9314,9808,19122,İstanbul,Şişli
50-54,8034,8596,16630,İstanbul,Şişli
55-59,6848,7257,14105,İstanbul,Şişli
60-64,5480,6175,11655,İstanbul,Şişli
65-69,3874,4823,8697,İstanbul,Şişli
70-74,2599,3795,6394,İstanbul,Şişli
75+,4041,7810,11851,İstanbul,Şişli
18-24,3525,3306,6831,Bilecik,Bilecik Merkez
25-29,2628,2551,5179,Bilecik,Bilecik Merkez
30-34,2856,2730,5586,Bilecik,Bilecik Merkez
35-39,3004,2913,5917,Bilecik,Bilecik Merkez
40-44,2669,2539,5208,Bilecik,Bilecik Merkez
45-49,2471,2216,4687,Bilecik,Bilecik Merkez
50-54,2000,1944,3944,Bilecik,Bilecik Merkez
55-59,1786,1757,3543,Bilecik,Bilecik Merkez
60-64,1410,1318,2728,Bilecik,Bilecik Merkez
65-69,961,1028,1989,Bilecik,Bilecik Merkez
70-74,644,865,1509,Bilecik,Bilecik Merkez
75+,1051,1587,2638,Bilecik,Bilecik Merkez
18-24,16000,15537,31537,İstanbul,Güngören
25-29,11979,11441,23420,İstanbul,Güngören
30-34,12236,11691,23927,İstanbul,Güngören
35-39,12629,12319,24948,İstanbul,Güngören
40-44,10913,11170,22083,İstanbul,Güngören
45-49,10154,10070,20224,İstanbul,Güngören
50-54,8848,8982,17830,İstanbul,Güngören
55-59,7547,7416,14963,İstanbul,Güngören
60-64,5483,5869,11352,İstanbul,Güngören
65-69,3756,4419,8175,İstanbul,Güngören
70-74,2275,2999,5274,İstanbul,Güngören
75+,2759,4583,7342,İstanbul,Güngören
18-24,1504,1625,3129,Uşak,Eşme
25-29,878,878,1756,Uşak,Eşme
30-34,1087,987,2074,Uşak,Eşme
35-39,1191,1111,2302,Uşak,Eşme
40-44,1147,1205,2352,Uşak,Eşme
45-49,1291,1303,2594,Uşak,Eşme
50-54,1370,1390,2760,Uşak,Eşme
55-59,1303,1356,2659,Uşak,Eşme
60-64,1152,1212,2364,Uşak,Eşme
65-69,887,1018,1905,Uşak,Eşme
70-74,617,814,1431,Uşak,Eşme
75+,1103,1489,2592,Uşak,Eşme
18-24,834,808,1642,Aydın,Karacasu
25-29,512,477,989,Aydın,Karacasu
30-34,539,481,1020,Aydın,Karacasu
35-39,573,581,1154,Aydın,Karacasu
40-44,606,592,1198,Aydın,Karacasu
45-49,684,678,1362,Aydın,Karacasu
50-54,650,707,1357,Aydın,Karacasu
55-59,690,681,1371,Aydın,Karacasu
60-64,596,634,1230,Aydın,Karacasu
65-69,437,559,996,Aydın,Karacasu
70-74,335,464,799,Aydın,Karacasu
75+,611,936,1547,Aydın,Karacasu
18-24,16404,16001,32405,İzmir,Konak
25-29,12884,11965,24849,İzmir,Konak
30-34,12912,12023,24935,İzmir,Konak
35-39,13715,13565,27280,İzmir,Konak
40-44,12847,13374,26221,İzmir,Konak
45-49,12089,13002,25091,İzmir,Konak
50-54,11781,12318,24099,İzmir,Konak
55-59,11080,11894,22974,İzmir,Konak
60-64,9872,10808,20680,İzmir,Konak
65-69,7439,9003,16442,İzmir,Konak
70-74,5228,7242,12470,İzmir,Konak
75+,7638,13705,21343,İzmir,Konak
18-24,551,578,1129,Aydın,Yenipazar
25-29,334,306,640,Aydın,Yenipazar
30-34,347,332,679,Aydın,Yenipazar
35-39,386,401,787,Aydın,Yenipazar
40-44,397,409,806,Aydın,Yenipazar
45-49,425,416,841,Aydın,Yenipazar
50-54,441,451,892,Aydın,Yenipazar
55-59,468,399,867,Aydın,Yenipazar
60-64,379,451,830,Aydın,Yenipazar
65-69,321,384,705,Aydın,Yenipazar
70-74,261,364,625,Aydın,Yenipazar
75+,517,766,1283,Aydın,Yenipazar
18-24,4795,4122,8917,Bayburt,Bayburt Merkez
25-29,2476,2263,4739,Bayburt,Bayburt Merkez
30-34,2294,2191,4485,Bayburt,Bayburt Merkez
35-39,2146,1893,4039,Bayburt,Bayburt Merkez
40-44,1895,1745,3640,Bayburt,Bayburt Merkez
45-49,1712,1727,3439,Bayburt,Bayburt Merkez
50-54,1679,1659,3338,Bayburt,Bayburt Merkez
55-59,1386,1418,2804,Bayburt,Bayburt Merkez
60-64,1342,1421,2763,Bayburt,Bayburt Merkez
65-69,1019,1127,2146,Bayburt,Bayburt Merkez
70-74,818,851,1669,Bayburt,Bayburt Merkez
75+,1206,1701,2907,Bayburt,Bayburt Merkez
18-24,29519,31906,61425,Kayseri,Melikgazi
25-29,19163,20983,40146,Kayseri,Melikgazi
30-34,21680,22760,44440,Kayseri,Melikgazi
35-39,23447,23551,46998,Kayseri,Melikgazi
40-44,20664,20051,40715,Kayseri,Melikgazi
45-49,17842,17756,35598,Kayseri,Melikgazi
50-54,14963,15112,30075,Kayseri,Melikgazi
55-59,12937,12854,25791,Kayseri,Melikgazi
60-64,10219,9820,20039,Kayseri,Melikgazi
65-69,7072,7059,14131,Kayseri,Melikgazi
70-74,4183,5253,9436,Kayseri,Melikgazi
75+,4878,6834,11712,Kayseri,Melikgazi
18-24,789,758,1547,Kastamonu,Araç
25-29,500,452,952,Kastamonu,Araç
30-34,491,457,948,Kastamonu,Araç
35-39,534,425,959,Kastamonu,Araç
40-44,455,470,925,Kastamonu,Araç
45-49,494,502,996,Kastamonu,Araç
50-54,557,626,1183,Kastamonu,Araç
55-59,708,703,1411,Kastamonu,Araç
60-64,768,834,1602,Kastamonu,Araç
65-69,676,740,1416,Kastamonu,Araç
70-74,492,560,1052,Kastamonu,Araç
75+,877,1210,2087,Kastamonu,Araç
18-24,10753,11181,21934,Siirt,Siirt Merkez
25-29,7240,7179,14419,Siirt,Siirt Merkez
30-34,6112,5770,11882,Siirt,Siirt Merkez
35-39,5411,5333,10744,Siirt,Siirt Merkez
40-44,3628,3548,7176,Siirt,Siirt Merkez
45-49,3337,2965,6302,Siirt,Siirt Merkez
50-54,2711,2468,5179,Siirt,Siirt Merkez
55-59,1905,1843,3748,Siirt,Siirt Merkez
60-64,1522,1629,3151,Siirt,Siirt Merkez
65-69,1129,1325,2454,Siirt,Siirt Merkez
70-74,688,955,1643,Siirt,Siirt Merkez
75+,902,1485,2387,Siirt,Siirt Merkez
18-24,1852,1802,3654,İzmir,Bayındır
25-29,1295,1158,2453,İzmir,Bayındır
30-34,1344,1206,2550,İzmir,Bayındır
35-39,1300,1281,2581,İzmir,Bayındır
40-44,1314,1326,2640,İzmir,Bayındır
45-49,1248,1266,2514,İzmir,Bayındır
50-54,1289,1343,2632,İzmir,Bayındır
55-59,1471,1446,2917,İzmir,Bayındır
60-64,1325,1333,2658,İzmir,Bayındır
65-69,1058,1146,2204,İzmir,Bayındır
70-74,759,925,1684,İzmir,Bayındır
75+,965,1733,2698,İzmir,Bayındır
18-24,3768,3716,7484,Gaziantep,İslahiye
25-29,2396,2179,4575,Gaziantep,İslahiye
30-34,2199,2106,4305,Gaziantep,İslahiye
35-39,2157,2189,4346,Gaziantep,İslahiye
40-44,2027,1978,4005,Gaziantep,İslahiye
45-49,1899,1845,3744,Gaziantep,İslahiye
50-54,1820,1780,3600,Gaziantep,İslahiye
55-59,1490,1519,3009,Gaziantep,İslahiye
60-64,1308,1331,2639,Gaziantep,İslahiye
65-69,884,1100,1984,Gaziantep,İslahiye
70-74,642,789,1431,Gaziantep,İslahiye
75+,898,1328,2226,Gaziantep,İslahiye
18-24,2178,2252,4430,Ardahan,Ardahan Merkez
25-29,1703,1556,3259,Ardahan,Ardahan Merkez
30-34,1612,1450,3062,Ardahan,Ardahan Merkez
35-39,1579,1360,2939,Ardahan,Ardahan Merkez
40-44,1385,1126,2511,Ardahan,Ardahan Merkez
45-49,1171,1007,2178,Ardahan,Ardahan Merkez
50-54,1009,916,1925,Ardahan,Ardahan Merkez
55-59,776,837,1613,Ardahan,Ardahan Merkez
60-64,787,710,1497,Ardahan,Ardahan Merkez
65-69,632,700,1332,Ardahan,Ardahan Merkez
70-74,542,588,1130,Ardahan,Ardahan Merkez
75+,639,869,1508,Ardahan,Ardahan Merkez
18-24,2009,1927,3936,Gaziantep,Araban
25-29,1157,1019,2176,Gaziantep,Araban
30-34,1105,1016,2121,Gaziantep,Araban
35-39,993,1056,2049,Gaziantep,Araban
40-44,914,844,1758,Gaziantep,Araban
45-49,796,763,1559,Gaziantep,Araban
50-54,704,761,1465,Gaziantep,Araban
55-59,553,655,1208,Gaziantep,Araban
60-64,513,472,985,Gaziantep,Araban
65-69,464,562,1026,Gaziantep,Araban
70-74,345,455,800,Gaziantep,Araban
75+,435,753,1188,Gaziantep,Araban
18-24,1699,1753,3452,Yozgat,Boğazlıyan
25-29,1091,1119,2210,Yozgat,Boğazlıyan
30-34,1207,1097,2304,Yozgat,Boğazlıyan
35-39,1169,992,2161,Yozgat,Boğazlıyan
40-44,1028,945,1973,Yozgat,Boğazlıyan
45-49,959,979,1938,Yozgat,Boğazlıyan
50-54,1076,1137,2213,Yozgat,Boğazlıyan
55-59,1141,1106,2247,Yozgat,Boğazlıyan
60-64,1059,1020,2079,Yozgat,Boğazlıyan
65-69,831,951,1782,Yozgat,Boğazlıyan
70-74,491,671,1162,Yozgat,Boğazlıyan
75+,606,1049,1655,Yozgat,Boğazlıyan
18-24,3550,3884,7434,İzmir,Tire
25-29,2643,2658,5301,İzmir,Tire
30-34,2916,2895,5811,İzmir,Tire
35-39,3201,3311,6512,İzmir,Tire
40-44,3076,3135,6211,İzmir,Tire
45-49,2847,2796,5643,İzmir,Tire
50-54,2760,2787,5547,İzmir,Tire
55-59,2822,2860,5682,İzmir,Tire
60-64,2596,2593,5189,İzmir,Tire
65-69,2035,2154,4189,İzmir,Tire
70-74,1394,1673,3067,İzmir,Tire
75+,1907,3060,4967,İzmir,Tire
18-24,16559,17022,33581,Trabzon,Ortahisar
25-29,11338,11530,22868,Trabzon,Ortahisar
30-34,12219,12723,24942,Trabzon,Ortahisar
35-39,12805,13207,26012,Trabzon,Ortahisar
40-44,11908,12133,24041,Trabzon,Ortahisar
45-49,10919,10956,21875,Trabzon,Ortahisar
50-54,9861,10381,20242,Trabzon,Ortahisar
55-59,9318,9076,18394,Trabzon,Ortahisar
60-64,7449,7598,15047,Trabzon,Ortahisar
65-69,4981,4965,9946,Trabzon,Ortahisar
70-74,2865,3510,6375,Trabzon,Ortahisar
75+,3893,6734,10627,Trabzon,Ortahisar
18-24,820,853,1673,Adana,Tufanbeyli
25-29,562,538,1100,Adana,Tufanbeyli
30-34,642,453,1095,Adana,Tufanbeyli
35-39,615,472,1087,Adana,Tufanbeyli
40-44,475,450,925,Adana,Tufanbeyli
45-49,511,490,1001,Adana,Tufanbeyli
50-54,539,573,1112,Adana,Tufanbeyli
55-59,549,537,1086,Adana,Tufanbeyli
60-64,509,435,944,Adana,Tufanbeyli
65-69,421,455,876,Adana,Tufanbeyli
70-74,309,409,718,Adana,Tufanbeyli
75+,505,633,1138,Adana,Tufanbeyli
18-24,46847,49282,96129,Ankara,Keçiören
25-29,35126,36934,72060,Ankara,Keçiören
30-34,36623,37565,74188,Ankara,Keçiören
35-39,37412,39550,76962,Ankara,Keçiören
40-44,34057,35777,69834,Ankara,Keçiören
45-49,31180,33441,64621,Ankara,Keçiören
50-54,28341,29230,57571,Ankara,Keçiören
55-59,23956,24296,48252,Ankara,Keçiören
60-64,17890,18658,36548,Ankara,Keçiören
65-69,11904,13651,25555,Ankara,Keçiören
70-74,7376,9838,17214,Ankara,Keçiören
75+,9397,15014,24411,Ankara,Keçiören
18-24,1117,1113,2230,Artvin,Borçka
25-29,761,750,1511,Artvin,Borçka
30-34,751,723,1474,Artvin,Borçka
35-39,805,706,1511,Artvin,Borçka
40-44,791,663,1454,Artvin,Borçka
45-49,809,757,1566,Artvin,Borçka
50-54,801,728,1529,Artvin,Borçka
55-59,734,646,1380,Artvin,Borçka
60-64,645,678,1323,Artvin,Borçka
65-69,504,513,1017,Artvin,Borçka
70-74,337,393,730,Artvin,Borçka
75+,495,759,1254,Artvin,Borçka
18-24,537,565,1102,Bartın,Amasra
25-29,376,374,750,Bartın,Amasra
30-34,511,474,985,Bartın,Amasra
35-39,557,502,1059,Bartın,Amasra
40-44,525,454,979,Bartın,Amasra
45-49,428,490,918,Bartın,Amasra
50-54,452,520,972,Bartın,Amasra
55-59,552,553,1105,Bartın,Amasra
60-64,529,590,1119,Bartın,Amasra
65-69,514,440,954,Bartın,Amasra
70-74,292,336,628,Bartın,Amasra
75+,346,542,888,Bartın,Amasra
18-24,1650,1769,3419,Niğde,Çiftlik
25-29,1135,967,2102,Niğde,Çiftlik
30-34,1032,784,1816,Niğde,Çiftlik
35-39,958,842,1800,Niğde,Çiftlik
40-44,767,729,1496,Niğde,Çiftlik
45-49,738,678,1416,Niğde,Çiftlik
50-54,608,566,1174,Niğde,Çiftlik
55-59,473,522,995,Niğde,Çiftlik
60-64,408,454,862,Niğde,Çiftlik
65-69,349,402,751,Niğde,Çiftlik
70-74,230,338,568,Niğde,Çiftlik
75+,348,514,862,Niğde,Çiftlik
18-24,1049,1014,2063,Aydın,Koçarlı
25-29,646,534,1180,Aydın,Koçarlı
30-34,576,556,1132,Aydın,Koçarlı
35-39,668,633,1301,Aydın,Koçarlı
40-44,693,698,1391,Aydın,Koçarlı
45-49,749,741,1490,Aydın,Koçarlı
50-54,861,793,1654,Aydın,Koçarlı
55-59,956,923,1879,Aydın,Koçarlı
60-64,769,834,1603,Aydın,Koçarlı
65-69,631,675,1306,Aydın,Koçarlı
70-74,479,580,1059,Aydın,Koçarlı
75+,789,1223,2012,Aydın,Koçarlı
18-24,480,489,969,Burdur,Tefenni
25-29,266,243,509,Burdur,Tefenni
30-34,289,254,543,Burdur,Tefenni
35-39,306,303,609,Burdur,Tefenni
40-44,330,328,658,Burdur,Tefenni
45-49,334,334,668,Burdur,Tefenni
50-54,367,342,709,Burdur,Tefenni
55-59,345,393,738,Burdur,Tefenni
60-64,335,392,727,Burdur,Tefenni
65-69,298,334,632,Burdur,Tefenni
70-74,236,309,545,Burdur,Tefenni
75+,380,561,941,Burdur,Tefenni
18-24,217,222,439,Trabzon,Köprübaşı
25-29,138,126,264,Trabzon,Köprübaşı
30-34,125,91,216,Trabzon,Köprübaşı
35-39,155,115,270,Trabzon,Köprübaşı
40-44,136,116,252,Trabzon,Köprübaşı
45-49,137,121,258,Trabzon,Köprübaşı
50-54,162,138,300,Trabzon,Köprübaşı
55-59,163,182,345,Trabzon,Köprübaşı
60-64,161,211,372,Trabzon,Köprübaşı
65-69,175,160,335,Trabzon,Köprübaşı
70-74,147,161,308,Trabzon,Köprübaşı
75+,173,311,484,Trabzon,Köprübaşı
18-24,10568,11186,21754,Ordu,Altınordu
25-29,6952,7690,14642,Ordu,Altınordu
30-34,7455,8152,15607,Ordu,Altınordu
35-39,8442,8996,17438,Ordu,Altınordu
40-44,7833,8177,16010,Ordu,Altınordu
45-49,7489,7404,14893,Ordu,Altınordu
50-54,7178,6971,14149,Ordu,Altınordu
55-59,5984,5814,11798,Ordu,Altınordu
60-64,4875,5194,10069,Ordu,Altınordu
65-69,3496,3533,7029,Ordu,Altınordu
70-74,2283,2558,4841,Ordu,Altınordu
75+,3549,5427,8976,Ordu,Altınordu
18-24,185,192,377,Çorum,Laçin
25-29,98,71,169,Çorum,Laçin
30-34,113,93,206,Çorum,Laçin
35-39,113,106,219,Çorum,Laçin
40-44,130,123,253,Çorum,Laçin
45-49,135,144,279,Çorum,Laçin
50-54,153,137,290,Çorum,Laçin
55-59,163,173,336,Çorum,Laçin
60-64,158,185,343,Çorum,Laçin
65-69,174,223,397,Çorum,Laçin
70-74,130,118,248,Çorum,Laçin
75+,222,261,483,Çorum,Laçin
18-24,1663,1883,3546,Muş,Hasköy
25-29,1034,990,2024,Muş,Hasköy
30-34,734,733,1467,Muş,Hasköy
35-39,761,786,1547,Muş,Hasköy
40-44,616,583,1199,Muş,Hasköy
45-49,500,452,952,Muş,Hasköy
50-54,527,402,929,Muş,Hasköy
55-59,402,349,751,Muş,Hasköy
60-64,289,330,619,Muş,Hasköy
65-69,182,212,394,Muş,Hasköy
70-74,124,179,303,Muş,Hasköy
75+,142,285,427,Muş,Hasköy
18-24,5231,5458,10689,Yozgat,Yozgat Merkez
25-29,3254,3583,6837,Yozgat,Yozgat Merkez
30-34,3558,3586,7144,Yozgat,Yozgat Merkez
35-39,3618,3475,7093,Yozgat,Yozgat Merkez
40-44,3173,3071,6244,Yozgat,Yozgat Merkez
45-49,2760,2899,5659,Yozgat,Yozgat Merkez
50-54,2807,2805,5612,Yozgat,Yozgat Merkez
55-59,2406,2408,4814,Yozgat,Yozgat Merkez
60-64,2078,2148,4226,Yozgat,Yozgat Merkez
65-69,1737,1826,3563,Yozgat,Yozgat Merkez
70-74,1141,1386,2527,Yozgat,Yozgat Merkez
75+,1592,2154,3746,Yozgat,Yozgat Merkez
18-24,615,555,1170,Adıyaman,Tut
25-29,361,274,635,Adıyaman,Tut
30-34,346,301,647,Adıyaman,Tut
35-39,355,330,685,Adıyaman,Tut
40-44,307,332,639,Adıyaman,Tut
45-49,295,292,587,Adıyaman,Tut
50-54,255,211,466,Adıyaman,Tut
55-59,229,222,451,Adıyaman,Tut
60-64,157,213,370,Adıyaman,Tut
65-69,205,218,423,Adıyaman,Tut
70-74,121,153,274,Adıyaman,Tut
75+,230,302,532,Adıyaman,Tut
18-24,3552,3795,7347,Konya,Beyşehir
25-29,2390,2399,4789,Konya,Beyşehir
30-34,2521,2449,4970,Konya,Beyşehir
35-39,2518,2630,5148,Konya,Beyşehir
40-44,2403,2263,4666,Konya,Beyşehir
45-49,2319,2217,4536,Konya,Beyşehir
50-54,2213,2256,4469,Konya,Beyşehir
55-59,2183,2095,4278,Konya,Beyşehir
60-64,1784,2001,3785,Konya,Beyşehir
65-69,1496,1636,3132,Konya,Beyşehir
70-74,989,1266,2255,Konya,Beyşehir
75+,1574,2181,3755,Konya,Beyşehir
18-24,595,576,1171,Giresun,Piraziz
25-29,319,296,615,Giresun,Piraziz
30-34,303,309,612,Giresun,Piraziz
35-39,334,347,681,Giresun,Piraziz
40-44,360,355,715,Giresun,Piraziz
45-49,415,392,807,Giresun,Piraziz
50-54,546,505,1051,Giresun,Piraziz
55-59,547,528,1075,Giresun,Piraziz
60-64,558,551,1109,Giresun,Piraziz
65-69,420,416,836,Giresun,Piraziz
70-74,249,354,603,Giresun,Piraziz
75+,536,767,1303,Giresun,Piraziz
18-24,670,626,1296,Kayseri,Sarıoğlan
25-29,440,368,808,Kayseri,Sarıoğlan
30-34,429,325,754,Kayseri,Sarıoğlan
35-39,479,376,855,Kayseri,Sarıoğlan
40-44,375,341,716,Kayseri,Sarıoğlan
45-49,376,398,774,Kayseri,Sarıoğlan
50-54,458,479,937,Kayseri,Sarıoğlan
55-59,474,497,971,Kayseri,Sarıoğlan
60-64,479,508,987,Kayseri,Sarıoğlan
65-69,439,457,896,Kayseri,Sarıoğlan
70-74,338,421,759,Kayseri,Sarıoğlan
75+,431,669,1100,Kayseri,Sarıoğlan
18-24,9026,9355,18381,İzmir,Torbalı
25-29,6716,6773,13489,İzmir,Torbalı
30-34,7060,6952,14012,İzmir,Torbalı
35-39,7469,7467,14936,İzmir,Torbalı
40-44,6453,6315,12768,İzmir,Torbalı
45-49,5673,5392,11065,İzmir,Torbalı
50-54,4987,4668,9655,İzmir,Torbalı
55-59,4291,4357,8648,İzmir,Torbalı
60-64,3590,3550,7140,İzmir,Torbalı
65-69,2525,2694,5219,İzmir,Torbalı
70-74,1585,1773,3358,İzmir,Torbalı
75+,1940,2910,4850,İzmir,Torbalı
18-24,12017,12290,24307,Uşak,Uşak Merkez
25-29,8108,8348,16456,Uşak,Uşak Merkez
30-34,9336,9499,18835,Uşak,Uşak Merkez
35-39,10010,10246,20256,Uşak,Uşak Merkez
40-44,9092,9149,18241,Uşak,Uşak Merkez
45-49,8301,8113,16414,Uşak,Uşak Merkez
50-54,7369,7577,14946,Uşak,Uşak Merkez
55-59,6581,6792,13373,Uşak,Uşak Merkez
60-64,5355,5565,10920,Uşak,Uşak Merkez
65-69,3884,4082,7966,Uşak,Uşak Merkez
70-74,2586,3027,5613,Uşak,Uşak Merkez
75+,3576,4887,8463,Uşak,Uşak Merkez
18-24,6812,6890,13702,Karabük,Karabük Merkez
25-29,4363,3909,8272,Karabük,Karabük Merkez
30-34,4278,4083,8361,Karabük,Karabük Merkez
35-39,4497,4675,9172,Karabük,Karabük Merkez
40-44,4455,4800,9255,Karabük,Karabük Merkez
45-49,4460,4489,8949,Karabük,Karabük Merkez
50-54,3906,3967,7873,Karabük,Karabük Merkez
55-59,3347,3569,6916,Karabük,Karabük Merkez
60-64,2767,3060,5827,Karabük,Karabük Merkez
65-69,2278,2437,4715,Karabük,Karabük Merkez
70-74,1444,1780,3224,Karabük,Karabük Merkez
75+,1986,2941,4927,Karabük,Karabük Merkez
18-24,10094,10779,20873,Van,Tuşba
25-29,6933,6853,13786,Van,Tuşba
30-34,6071,5438,11509,Van,Tuşba
35-39,5466,4997,10463,Van,Tuşba
40-44,3844,3454,7298,Van,Tuşba
45-49,3127,2711,5838,Van,Tuşba
50-54,2768,2489,5257,Van,Tuşba
55-59,2017,1930,3947,Van,Tuşba
60-64,1329,1577,2906,Van,Tuşba
65-69,1018,1091,2109,Van,Tuşba
70-74,587,744,1331,Van,Tuşba
75+,771,974,1745,Van,Tuşba
18-24,340,295,635,Kırıkkale,Delice
25-29,189,150,339,Kırıkkale,Delice
30-34,164,144,308,Kırıkkale,Delice
35-39,205,177,382,Kırıkkale,Delice
40-44,182,175,357,Kırıkkale,Delice
45-49,236,229,465,Kırıkkale,Delice
50-54,279,250,529,Kırıkkale,Delice
55-59,308,310,618,Kırıkkale,Delice
60-64,329,341,670,Kırıkkale,Delice
65-69,313,412,725,Kırıkkale,Delice
70-74,268,396,664,Kırıkkale,Delice
75+,456,617,1073,Kırıkkale,Delice
18-24,2473,2313,4786,Bitlis,Mutki
25-29,1366,1121,2487,Bitlis,Mutki
30-34,915,865,1780,Bitlis,Mutki
35-39,889,857,1746,Bitlis,Mutki
40-44,723,675,1398,Bitlis,Mutki
45-49,747,560,1307,Bitlis,Mutki
50-54,593,461,1054,Bitlis,Mutki
55-59,468,381,849,Bitlis,Mutki
60-64,344,379,723,Bitlis,Mutki
65-69,241,358,599,Bitlis,Mutki
70-74,198,203,401,Bitlis,Mutki
75+,181,389,570,Bitlis,Mutki
18-24,1186,1257,2443,İzmir,Güzelbahçe
25-29,864,873,1737,İzmir,Güzelbahçe
30-34,868,987,1855,İzmir,Güzelbahçe
35-39,1142,1399,2541,İzmir,Güzelbahçe
40-44,1254,1475,2729,İzmir,Güzelbahçe
45-49,1216,1364,2580,İzmir,Güzelbahçe
50-54,1179,1289,2468,İzmir,Güzelbahçe
55-59,1135,1074,2209,İzmir,Güzelbahçe
60-64,906,940,1846,İzmir,Güzelbahçe
65-69,676,706,1382,İzmir,Güzelbahçe
70-74,453,536,989,İzmir,Güzelbahçe
75+,601,753,1354,İzmir,Güzelbahçe
18-24,9310,10061,19371,Ağrı,Ağrı Merkez
25-29,6529,6231,12760,Ağrı,Ağrı Merkez
30-34,5605,4949,10554,Ağrı,Ağrı Merkez
35-39,5359,4909,10268,Ağrı,Ağrı Merkez
40-44,3870,3460,7330,Ağrı,Ağrı Merkez
45-49,3247,2843,6090,Ağrı,Ağrı Merkez
50-54,2679,2124,4803,Ağrı,Ağrı Merkez
55-59,2124,1804,3928,Ağrı,Ağrı Merkez
60-64,1621,1600,3221,Ağrı,Ağrı Merkez
65-69,1011,1221,2232,Ağrı,Ağrı Merkez
70-74,797,898,1695,Ağrı,Ağrı Merkez
75+,936,1232,2168,Ağrı,Ağrı Merkez
18-24,1723,1715,3438,Antalya,Kemer
25-29,1347,1275,2622,Antalya,Kemer
30-34,1812,1500,3312,Antalya,Kemer
35-39,2136,1729,3865,Antalya,Kemer
40-44,1999,1442,3441,Antalya,Kemer
45-49,1698,1348,3046,Antalya,Kemer
50-54,1419,1127,2546,Antalya,Kemer
55-59,1131,861,1992,Antalya,Kemer
60-64,793,675,1468,Antalya,Kemer
65-69,561,508,1069,Antalya,Kemer
70-74,374,376,750,Antalya,Kemer
75+,465,531,996,Antalya,Kemer
18-24,1065,1099,2164,Düzce,Gölyaka
25-29,692,689,1381,Düzce,Gölyaka
30-34,720,623,1343,Düzce,Gölyaka
35-39,781,694,1475,Düzce,Gölyaka
40-44,739,651,1390,Düzce,Gölyaka
45-49,675,670,1345,Düzce,Gölyaka
50-54,673,660,1333,Düzce,Gölyaka
55-59,674,633,1307,Düzce,Gölyaka
60-64,592,637,1229,Düzce,Gölyaka
65-69,449,445,894,Düzce,Gölyaka
70-74,290,365,655,Düzce,Gölyaka
75+,409,626,1035,Düzce,Gölyaka
18-24,978,1140,2118,Yozgat,Çekerek
25-29,535,531,1066,Yozgat,Çekerek
30-34,515,510,1025,Yozgat,Çekerek
35-39,540,574,1114,Yozgat,Çekerek
40-44,547,608,1155,Yozgat,Çekerek
45-49,635,582,1217,Yozgat,Çekerek
50-54,582,627,1209,Yozgat,Çekerek
55-59,628,604,1232,Yozgat,Çekerek
60-64,610,617,1227,Yozgat,Çekerek
65-69,505,578,1083,Yozgat,Çekerek
70-74,403,434,837,Yozgat,Çekerek
75+,438,634,1072,Yozgat,Çekerek
18-24,1467,1477,2944,Batman,Gercüş
25-29,796,715,1511,Batman,Gercüş
30-34,546,487,1033,Batman,Gercüş
35-39,484,547,1031,Batman,Gercüş
40-44,454,499,953,Batman,Gercüş
45-49,450,393,843,Batman,Gercüş
50-54,343,349,692,Batman,Gercüş
55-59,249,288,537,Batman,Gercüş
60-64,237,305,542,Batman,Gercüş
65-69,250,340,590,Batman,Gercüş
70-74,230,300,530,Batman,Gercüş
75+,399,550,949,Batman,Gercüş
18-24,3934,4240,8174,Kahramanmaraş,Türkoğlu
25-29,2516,2358,4874,Kahramanmaraş,Türkoğlu
30-34,2667,2484,5151,Kahramanmaraş,Türkoğlu
35-39,2555,2293,4848,Kahramanmaraş,Türkoğlu
40-44,2238,1996,4234,Kahramanmaraş,Türkoğlu
45-49,1898,1896,3794,Kahramanmaraş,Türkoğlu
50-54,1784,1633,3417,Kahramanmaraş,Türkoğlu
55-59,1424,1293,2717,Kahramanmaraş,Türkoğlu
60-64,1247,1173,2420,Kahramanmaraş,Türkoğlu
65-69,760,989,1749,Kahramanmaraş,Türkoğlu
70-74,704,740,1444,Kahramanmaraş,Türkoğlu
75+,920,1266,2186,Kahramanmaraş,Türkoğlu
18-24,2232,2103,4335,İzmir,Kiraz
25-29,1410,1300,2710,İzmir,Kiraz
30-34,1592,1483,3075,İzmir,Kiraz
35-39,1657,1577,3234,İzmir,Kiraz
40-44,1666,1569,3235,İzmir,Kiraz
45-49,1550,1444,2994,İzmir,Kiraz
50-54,1556,1452,3008,İzmir,Kiraz
55-59,1514,1304,2818,İzmir,Kiraz
60-64,1174,1228,2402,İzmir,Kiraz
65-69,937,1046,1983,İzmir,Kiraz
70-74,706,788,1494,İzmir,Kiraz
75+,956,1417,2373,İzmir,Kiraz
18-24,120,44,164,Bingöl,Yayladere
25-29,247,54,301,Bingöl,Yayladere
30-34,55,34,89,Bingöl,Yayladere
35-39,54,25,79,Bingöl,Yayladere
40-44,52,32,84,Bingöl,Yayladere
45-49,54,38,92,Bingöl,Yayladere
50-54,60,44,104,Bingöl,Yayladere
55-59,71,75,146,Bingöl,Yayladere
60-64,123,94,217,Bingöl,Yayladere
65-69,104,76,180,Bingöl,Yayladere
70-74,47,48,95,Bingöl,Yayladere
75+,70,95,165,Bingöl,Yayladere
18-24,20149,21646,41795,Van,İpekyolu
25-29,14364,14952,29316,Van,İpekyolu
30-34,12374,11957,24331,Van,İpekyolu
35-39,11747,11726,23473,Van,İpekyolu
40-44,8122,8029,16151,Van,İpekyolu
45-49,6724,6186,12910,Van,İpekyolu
50-54,5798,5177,10975,Van,İpekyolu
55-59,4259,4248,8507,Van,İpekyolu
60-64,3117,3447,6564,Van,İpekyolu
65-69,2141,2480,4621,Van,İpekyolu
70-74,1342,1625,2967,Van,İpekyolu
75+,1583,2331,3914,Van,İpekyolu
18-24,810,789,1599,Trabzon,Tonya
25-29,461,439,900,Trabzon,Tonya
30-34,460,361,821,Trabzon,Tonya
35-39,470,396,866,Trabzon,Tonya
40-44,481,450,931,Trabzon,Tonya
45-49,546,527,1073,Trabzon,Tonya
50-54,533,563,1096,Trabzon,Tonya
55-59,484,554,1038,Trabzon,Tonya
60-64,492,530,1022,Trabzon,Tonya
65-69,313,427,740,Trabzon,Tonya
70-74,212,406,618,Trabzon,Tonya
75+,366,778,1144,Trabzon,Tonya
18-24,1934,1776,3710,Erzurum,Tekman
25-29,984,906,1890,Erzurum,Tekman
30-34,812,745,1557,Erzurum,Tekman
35-39,769,747,1516,Erzurum,Tekman
40-44,596,596,1192,Erzurum,Tekman
45-49,488,492,980,Erzurum,Tekman
50-54,526,421,947,Erzurum,Tekman
55-59,435,396,831,Erzurum,Tekman
60-64,416,437,853,Erzurum,Tekman
65-69,244,326,570,Erzurum,Tekman
70-74,203,280,483,Erzurum,Tekman
75+,207,319,526,Erzurum,Tekman
18-24,1152,1125,2277,Edirne,İpsala
25-29,785,706,1491,Edirne,İpsala
30-34,916,797,1713,Edirne,İpsala
35-39,967,806,1773,Edirne,İpsala
40-44,965,840,1805,Edirne,İpsala
45-49,999,947,1946,Edirne,İpsala
50-54,1099,1073,2172,Edirne,İpsala
55-59,1174,1104,2278,Edirne,İpsala
60-64,1048,985,2033,Edirne,İpsala
65-69,763,805,1568,Edirne,İpsala
70-74,550,590,1140,Edirne,İpsala
75+,719,1069,1788,Edirne,İpsala
18-24,232,262,494,Bolu,Dörtdivan
25-29,146,126,272,Bolu,Dörtdivan
30-34,157,114,271,Bolu,Dörtdivan
35-39,141,117,258,Bolu,Dörtdivan
40-44,160,141,301,Bolu,Dörtdivan
45-49,177,203,380,Bolu,Dörtdivan
50-54,188,203,391,Bolu,Dörtdivan
55-59,259,260,519,Bolu,Dörtdivan
60-64,309,330,639,Bolu,Dörtdivan
65-69,257,331,588,Bolu,Dörtdivan
70-74,203,260,463,Bolu,Dörtdivan
75+,318,480,798,Bolu,Dörtdivan
18-24,2994,2838,5832,Muğla,Seydikemer
25-29,1775,1503,3278,Muğla,Seydikemer
30-34,1797,1585,3382,Muğla,Seydikemer
35-39,2060,1832,3892,Muğla,Seydikemer
40-44,2097,1917,4014,Muğla,Seydikemer
45-49,2318,2200,4518,Muğla,Seydikemer
50-54,2161,2187,4348,Muğla,Seydikemer
55-59,2061,2005,4066,Muğla,Seydikemer
60-64,1715,1838,3553,Muğla,Seydikemer
65-69,1324,1479,2803,Muğla,Seydikemer
70-74,1017,1181,2198,Muğla,Seydikemer
75+,1855,2199,4054,Muğla,Seydikemer
18-24,245,224,469,Osmaniye,Hasanbeyli
25-29,165,127,292,Osmaniye,Hasanbeyli
30-34,148,114,262,Osmaniye,Hasanbeyli
35-39,126,90,216,Osmaniye,Hasanbeyli
40-44,118,109,227,Osmaniye,Hasanbeyli
45-49,97,136,233,Osmaniye,Hasanbeyli
50-54,141,152,293,Osmaniye,Hasanbeyli
55-59,157,152,309,Osmaniye,Hasanbeyli
60-64,146,170,316,Osmaniye,Hasanbeyli
65-69,130,104,234,Osmaniye,Hasanbeyli
70-74,82,93,175,Osmaniye,Hasanbeyli
75+,103,132,235,Osmaniye,Hasanbeyli
18-24,254,187,441,Kastamonu,Çatalzeytin
25-29,137,144,281,Kastamonu,Çatalzeytin
30-34,144,140,284,Kastamonu,Çatalzeytin
35-39,156,126,282,Kastamonu,Çatalzeytin
40-44,154,153,307,Kastamonu,Çatalzeytin
45-49,173,152,325,Kastamonu,Çatalzeytin
50-54,182,205,387,Kastamonu,Çatalzeytin
55-59,288,281,569,Kastamonu,Çatalzeytin
60-64,353,351,704,Kastamonu,Çatalzeytin
65-69,359,319,678,Kastamonu,Çatalzeytin
70-74,225,245,470,Kastamonu,Çatalzeytin
75+,314,488,802,Kastamonu,Çatalzeytin
18-24,2158,2150,4308,Erzurum,Karayazı
25-29,1038,876,1914,Erzurum,Karayazı
30-34,803,699,1502,Erzurum,Karayazı
35-39,786,837,1623,Erzurum,Karayazı
40-44,672,598,1270,Erzurum,Karayazı
45-49,658,624,1282,Erzurum,Karayazı
50-54,492,467,959,Erzurum,Karayazı
55-59,479,412,891,Erzurum,Karayazı
60-64,346,377,723,Erzurum,Karayazı
65-69,304,360,664,Erzurum,Karayazı
70-74,227,275,502,Erzurum,Karayazı
75+,256,356,612,Erzurum,Karayazı
18-24,147,137,284,Kastamonu,Hanönü
25-29,122,111,233,Kastamonu,Hanönü
30-34,104,91,195,Kastamonu,Hanönü
35-39,110,115,225,Kastamonu,Hanönü
40-44,130,90,220,Kastamonu,Hanönü
45-49,104,94,198,Kastamonu,Hanönü
50-54,129,125,254,Kastamonu,Hanönü
55-59,186,153,339,Kastamonu,Hanönü
60-64,171,161,332,Kastamonu,Hanönü
65-69,125,158,283,Kastamonu,Hanönü
70-74,134,139,273,Kastamonu,Hanönü
75+,185,284,469,Kastamonu,Hanönü
18-24,292,261,553,Eskişehir,İnönü
25-29,192,159,351,Eskişehir,İnönü
30-34,197,152,349,Eskişehir,İnönü
35-39,196,172,368,Eskişehir,İnönü
40-44,216,201,417,Eskişehir,İnönü
45-49,231,210,441,Eskişehir,İnönü
50-54,219,235,454,Eskişehir,İnönü
55-59,287,249,536,Eskişehir,İnönü
60-64,243,245,488,Eskişehir,İnönü
65-69,210,219,429,Eskişehir,İnönü
70-74,141,200,341,Eskişehir,İnönü
75+,261,364,625,Eskişehir,İnönü
18-24,2897,2961,5858,Konya,Ilgın
25-29,1607,1635,3242,Konya,Ilgın
30-34,1755,1677,3432,Konya,Ilgın
35-39,1701,1721,3422,Konya,Ilgın
40-44,1692,1753,3445,Konya,Ilgın
45-49,1675,1852,3527,Konya,Ilgın
50-54,1802,1902,3704,Konya,Ilgın
55-59,1821,1873,3694,Konya,Ilgın
60-64,1469,1558,3027,Konya,Ilgın
65-69,1207,1409,2616,Konya,Ilgın
70-74,891,1173,2064,Konya,Ilgın
75+,1272,1811,3083,Konya,Ilgın
18-24,485,460,945,Tokat,Artova
25-29,192,195,387,Tokat,Artova
30-34,226,254,480,Tokat,Artova
35-39,273,260,533,Tokat,Artova
40-44,262,241,503,Tokat,Artova
45-49,270,251,521,Tokat,Artova
50-54,238,238,476,Tokat,Artova
55-59,260,274,534,Tokat,Artova
60-64,254,311,565,Tokat,Artova
65-69,222,211,433,Tokat,Artova
70-74,204,243,447,Tokat,Artova
75+,271,284,555,Tokat,Artova
18-24,14343,15301,29644,Çorum,Çorum Merkez
25-29,9327,9989,19316,Çorum,Çorum Merkez
30-34,10059,10444,20503,Çorum,Çorum Merkez
35-39,11283,11725,23008,Çorum,Çorum Merkez
40-44,10364,10655,21019,Çorum,Çorum Merkez
45-49,9430,9455,18885,Çorum,Çorum Merkez
50-54,8574,8650,17224,Çorum,Çorum Merkez
55-59,7566,7900,15466,Çorum,Çorum Merkez
60-64,6477,6567,13044,Çorum,Çorum Merkez
65-69,4789,5186,9975,Çorum,Çorum Merkez
70-74,3386,3876,7262,Çorum,Çorum Merkez
75+,4352,6066,10418,Çorum,Çorum Merkez
18-24,717,693,1410,Kütahya,Altıntaş
25-29,418,428,846,Kütahya,Altıntaş
30-34,508,482,990,Kütahya,Altıntaş
35-39,530,492,1022,Kütahya,Altıntaş
40-44,523,461,984,Kütahya,Altıntaş
45-49,514,504,1018,Kütahya,Altıntaş
50-54,539,566,1105,Kütahya,Altıntaş
55-59,575,601,1176,Kütahya,Altıntaş
60-64,554,537,1091,Kütahya,Altıntaş
65-69,469,527,996,Kütahya,Altıntaş
70-74,322,368,690,Kütahya,Altıntaş
75+,501,618,1119,Kütahya,Altıntaş
18-24,272,272,544,Kastamonu,Azdavay
25-29,213,166,379,Kastamonu,Azdavay
30-34,188,165,353,Kastamonu,Azdavay
35-39,199,158,357,Kastamonu,Azdavay
40-44,170,149,319,Kastamonu,Azdavay
45-49,187,198,385,Kastamonu,Azdavay
50-54,269,253,522,Kastamonu,Azdavay
55-59,289,311,600,Kastamonu,Azdavay
60-64,319,345,664,Kastamonu,Azdavay
65-69,290,315,605,Kastamonu,Azdavay
70-74,214,269,483,Kastamonu,Azdavay
75+,434,467,901,Kastamonu,Azdavay
18-24,413,454,867,Yalova,Armutlu
25-29,308,291,599,Yalova,Armutlu
30-34,332,300,632,Yalova,Armutlu
35-39,348,306,654,Yalova,Armutlu
40-44,283,271,554,Yalova,Armutlu
45-49,287,262,549,Yalova,Armutlu
50-54,303,278,581,Yalova,Armutlu
55-59,277,279,556,Yalova,Armutlu
60-64,276,268,544,Yalova,Armutlu
65-69,236,214,450,Yalova,Armutlu
70-74,170,180,350,Yalova,Armutlu
75+,226,267,493,Yalova,Armutlu
18-24,4435,4820,9255,Sakarya,Erenler
25-29,3327,3236,6563,Sakarya,Erenler
30-34,3341,3357,6698,Sakarya,Erenler
35-39,3526,3489,7015,Sakarya,Erenler
40-44,3141,3109,6250,Sakarya,Erenler
45-49,2870,2717,5587,Sakarya,Erenler
50-54,2468,2492,4960,Sakarya,Erenler
55-59,2123,2143,4266,Sakarya,Erenler
60-64,1876,1872,3748,Sakarya,Erenler
65-69,1346,1390,2736,Sakarya,Erenler
70-74,783,948,1731,Sakarya,Erenler
75+,898,1263,2161,Sakarya,Erenler
18-24,12694,13240,25934,İzmir,Karşıyaka
25-29,10551,11916,22467,İzmir,Karşıyaka
30-34,12754,13956,26710,İzmir,Karşıyaka
35-39,14431,15994,30425,İzmir,Karşıyaka
40-44,13007,14773,27780,İzmir,Karşıyaka
45-49,11673,13747,25420,İzmir,Karşıyaka
50-54,10830,12640,23470,İzmir,Karşıyaka
55-59,10266,12548,22814,İzmir,Karşıyaka
60-64,9546,11519,21065,İzmir,Karşıyaka
65-69,7737,9409,17146,İzmir,Karşıyaka
70-74,5532,7165,12697,İzmir,Karşıyaka
75+,6970,11405,18375,İzmir,Karşıyaka
18-24,512,587,1099,Konya,Çeltik
25-29,287,268,555,Konya,Çeltik
30-34,280,248,528,Konya,Çeltik
35-39,327,294,621,Konya,Çeltik
40-44,330,342,672,Konya,Çeltik
45-49,379,327,706,Konya,Çeltik
50-54,373,347,720,Konya,Çeltik
55-59,311,280,591,Konya,Çeltik
60-64,205,234,439,Konya,Çeltik
65-69,177,240,417,Konya,Çeltik
70-74,131,202,333,Konya,Çeltik
75+,201,249,450,Konya,Çeltik
18-24,6171,6233,12404,Şanlıurfa,Birecik
25-29,3596,3476,7072,Şanlıurfa,Birecik
30-34,3182,3169,6351,Şanlıurfa,Birecik
35-39,2885,2951,5836,Şanlıurfa,Birecik
40-44,2322,2466,4788,Şanlıurfa,Birecik
45-49,2078,2113,4191,Şanlıurfa,Birecik
50-54,1752,1773,3525,Şanlıurfa,Birecik
55-59,1377,1434,2811,Şanlıurfa,Birecik
60-64,997,1176,2173,Şanlıurfa,Birecik
65-69,809,973,1782,Şanlıurfa,Birecik
70-74,531,783,1314,Şanlıurfa,Birecik
75+,753,1194,1947,Şanlıurfa,Birecik
18-24,4291,4807,9098,Yozgat,Sorgun
25-29,2755,2580,5335,Yozgat,Sorgun
30-34,2758,2585,5343,Yozgat,Sorgun
35-39,2821,2577,5398,Yozgat,Sorgun
40-44,2356,2412,4768,Yozgat,Sorgun
45-49,2329,2321,4650,Yozgat,Sorgun
50-54,2226,2273,4499,Yozgat,Sorgun
55-59,1966,2022,3988,Yozgat,Sorgun
60-64,1770,1796,3566,Yozgat,Sorgun
65-69,1521,1639,3160,Yozgat,Sorgun
70-74,1062,1326,2388,Yozgat,Sorgun
75+,1397,1799,3196,Yozgat,Sorgun
18-24,754,656,1410,Karaman,Sarıveliler
25-29,427,312,739,Karaman,Sarıveliler
30-34,375,265,640,Karaman,Sarıveliler
35-39,314,335,649,Karaman,Sarıveliler
40-44,335,333,668,Karaman,Sarıveliler
45-49,396,388,784,Karaman,Sarıveliler
50-54,306,330,636,Karaman,Sarıveliler
55-59,311,301,612,Karaman,Sarıveliler
60-64,278,314,592,Karaman,Sarıveliler
65-69,276,300,576,Karaman,Sarıveliler
70-74,210,249,459,Karaman,Sarıveliler
75+,406,438,844,Karaman,Sarıveliler
18-24,8444,8918,17362,İzmir,Menemen
25-29,7040,6919,13959,İzmir,Menemen
30-34,7339,6965,14304,İzmir,Menemen
35-39,7526,7555,15081,İzmir,Menemen
40-44,6430,6230,12660,İzmir,Menemen
45-49,5623,5427,11050,İzmir,Menemen
50-54,4876,4672,9548,İzmir,Menemen
55-59,4322,4071,8393,İzmir,Menemen
60-64,3303,3326,6629,İzmir,Menemen
65-69,2238,2186,4424,İzmir,Menemen
70-74,1317,1571,2888,İzmir,Menemen
75+,1619,2579,4198,İzmir,Menemen
18-24,31813,31753,63566,İstanbul,Bahçelievler
25-29,26031,25012,51043,İstanbul,Bahçelievler
30-34,25992,25457,51449,İstanbul,Bahçelievler
35-39,26652,26256,52908,İstanbul,Bahçelievler
40-44,23070,22844,45914,İstanbul,Bahçelievler
45-49,20346,20398,40744,İstanbul,Bahçelievler
50-54,17370,17291,34661,İstanbul,Bahçelievler
55-59,14235,14180,28415,İstanbul,Bahçelievler
60-64,10356,11107,21463,İstanbul,Bahçelievler
65-69,7026,7929,14955,İstanbul,Bahçelievler
70-74,4239,5258,9497,İstanbul,Bahçelievler
75+,4913,7829,12742,İstanbul,Bahçelievler
18-24,28007,28437,56444,İstanbul,Esenler
25-29,20269,18999,39268,İstanbul,Esenler
30-34,20028,18545,38573,İstanbul,Esenler
35-39,20590,19356,39946,İstanbul,Esenler
40-44,17720,16934,34654,İstanbul,Esenler
45-49,15846,14449,30295,İstanbul,Esenler
50-54,12717,11329,24046,İstanbul,Esenler
55-59,9034,8405,17439,İstanbul,Esenler
60-64,5982,6089,12071,İstanbul,Esenler
65-69,3559,4145,7704,İstanbul,Esenler
70-74,1917,2625,4542,İstanbul,Esenler
75+,2149,3656,5805,İstanbul,Esenler
18-24,2392,2421,4813,Ankara,Elmadağ
25-29,1554,1590,3144,Ankara,Elmadağ
30-34,1646,1579,3225,Ankara,Elmadağ
35-39,1766,1687,3453,Ankara,Elmadağ
40-44,1591,1570,3161,Ankara,Elmadağ
45-49,1567,1506,3073,Ankara,Elmadağ
50-54,1556,1448,3004,Ankara,Elmadağ
55-59,1237,1233,2470,Ankara,Elmadağ
60-64,914,960,1874,Ankara,Elmadağ
65-69,739,808,1547,Ankara,Elmadağ
70-74,486,543,1029,Ankara,Elmadağ
75+,624,922,1546,Ankara,Elmadağ
18-24,1542,1371,2913,Hatay,Yayladağı
25-29,871,717,1588,Hatay,Yayladağı
30-34,845,760,1605,Hatay,Yayladağı
35-39,880,824,1704,Hatay,Yayladağı
40-44,792,749,1541,Hatay,Yayladağı
45-49,792,812,1604,Hatay,Yayladağı
50-54,770,751,1521,Hatay,Yayladağı
55-59,619,683,1302,Hatay,Yayladağı
60-64,522,613,1135,Hatay,Yayladağı
65-69,447,517,964,Hatay,Yayladağı
70-74,317,412,729,Hatay,Yayladağı
75+,735,849,1584,Hatay,Yayladağı
18-24,703,692,1395,Çorum,Mecitözü
25-29,315,307,622,Çorum,Mecitözü
30-34,396,336,732,Çorum,Mecitözü
35-39,452,437,889,Çorum,Mecitözü
40-44,455,463,918,Çorum,Mecitözü
45-49,544,456,1000,Çorum,Mecitözü
50-54,556,532,1088,Çorum,Mecitözü
55-59,572,583,1155,Çorum,Mecitözü
60-64,540,577,1117,Çorum,Mecitözü
65-69,534,557,1091,Çorum,Mecitözü
70-74,380,507,887,Çorum,Mecitözü
75+,595,840,1435,Çorum,Mecitözü
18-24,237,243,480,Sinop,Dikmen
25-29,125,86,211,Sinop,Dikmen
30-34,90,76,166,Sinop,Dikmen
35-39,92,68,160,Sinop,Dikmen
40-44,83,109,192,Sinop,Dikmen
45-49,133,106,239,Sinop,Dikmen
50-54,189,185,374,Sinop,Dikmen
55-59,172,168,340,Sinop,Dikmen
60-64,238,273,511,Sinop,Dikmen
65-69,219,245,464,Sinop,Dikmen
70-74,173,173,346,Sinop,Dikmen
75+,329,395,724,Sinop,Dikmen
18-24,7812,8117,15929,İstanbul,Bakırköy
25-29,6426,7446,13872,İstanbul,Bakırköy
30-34,7309,8663,15972,İstanbul,Bakırköy
35-39,8459,9988,18447,İstanbul,Bakırköy
40-44,7920,9214,17134,İstanbul,Bakırköy
45-49,7243,8559,15802,İstanbul,Bakırköy
50-54,6689,7870,14559,İstanbul,Bakırköy
55-59,6477,7575,14052,İstanbul,Bakırköy
60-64,5723,6686,12409,İstanbul,Bakırköy
65-69,4510,5428,9938,İstanbul,Bakırköy
70-74,3326,4236,7562,İstanbul,Bakırköy
75+,4771,8003,12774,İstanbul,Bakırköy
18-24,473,468,941,Denizli,Bozkurt
25-29,296,254,550,Denizli,Bozkurt
30-34,358,321,679,Denizli,Bozkurt
35-39,409,321,730,Denizli,Bozkurt
40-44,376,339,715,Denizli,Bozkurt
45-49,373,395,768,Denizli,Bozkurt
50-54,371,385,756,Denizli,Bozkurt
55-59,434,429,863,Denizli,Bozkurt
60-64,338,350,688,Denizli,Bozkurt
65-69,290,331,621,Denizli,Bozkurt
70-74,209,294,503,Denizli,Bozkurt
75+,345,502,847,Denizli,Bozkurt
18-24,515,460,975,Balıkesir,Balya
25-29,303,231,534,Balıkesir,Balya
30-34,279,251,530,Balıkesir,Balya
35-39,349,320,669,Balıkesir,Balya
40-44,376,387,763,Balıkesir,Balya
45-49,457,418,875,Balıkesir,Balya
50-54,505,469,974,Balıkesir,Balya
55-59,499,553,1052,Balıkesir,Balya
60-64,527,544,1071,Balıkesir,Balya
65-69,470,605,1075,Balıkesir,Balya
70-74,434,472,906,Balıkesir,Balya
75+,816,1025,1841,Balıkesir,Balya
18-24,266,313,579,Konya,Tuzlukçu
25-29,159,149,308,Konya,Tuzlukçu
30-34,165,140,305,Konya,Tuzlukçu
35-39,174,184,358,Konya,Tuzlukçu
40-44,199,189,388,Konya,Tuzlukçu
45-49,201,253,454,Konya,Tuzlukçu
50-54,236,254,490,Konya,Tuzlukçu
55-59,280,276,556,Konya,Tuzlukçu
60-64,214,229,443,Konya,Tuzlukçu
65-69,208,229,437,Konya,Tuzlukçu
70-74,156,184,340,Konya,Tuzlukçu
75+,236,347,583,Konya,Tuzlukçu
18-24,2346,2470,4816,Çorum,Sungurlu
25-29,1247,1262,2509,Çorum,Sungurlu
30-34,1246,1362,2608,Çorum,Sungurlu
35-39,1551,1514,3065,Çorum,Sungurlu
40-44,1468,1452,2920,Çorum,Sungurlu
45-49,1513,1484,2997,Çorum,Sungurlu
50-54,1515,1472,2987,Çorum,Sungurlu
55-59,1504,1601,3105,Çorum,Sungurlu
60-64,1415,1604,3019,Çorum,Sungurlu
65-69,1343,1604,2947,Çorum,Sungurlu
70-74,1040,1179,2219,Çorum,Sungurlu
75+,1589,2052,3641,Çorum,Sungurlu
18-24,372,364,736,Denizli,Çardak
25-29,252,205,457,Denizli,Çardak
30-34,320,271,591,Denizli,Çardak
35-39,341,288,629,Denizli,Çardak
40-44,319,243,562,Denizli,Çardak
45-49,271,268,539,Denizli,Çardak
50-54,305,264,569,Denizli,Çardak
55-59,292,329,621,Denizli,Çardak
60-64,247,266,513,Denizli,Çardak
65-69,227,264,491,Denizli,Çardak
70-74,147,171,318,Denizli,Çardak
75+,253,385,638,Denizli,Çardak
18-24,737,799,1536,Denizli,Çameli
25-29,523,393,916,Denizli,Çameli
30-34,566,418,984,Denizli,Çameli
35-39,551,502,1053,Denizli,Çameli
40-44,605,567,1172,Denizli,Çameli
45-49,677,650,1327,Denizli,Çameli
50-54,706,726,1432,Denizli,Çameli
55-59,685,714,1399,Denizli,Çameli
60-64,673,683,1356,Denizli,Çameli
65-69,517,538,1055,Denizli,Çameli
70-74,356,485,841,Denizli,Çameli
75+,804,916,1720,Denizli,Çameli
18-24,1705,1846,3551,Balıkesir,Susurluk
25-29,1208,1072,2280,Balıkesir,Susurluk
30-34,1165,1078,2243,Balıkesir,Susurluk
35-39,1333,1273,2606,Balıkesir,Susurluk
40-44,1321,1347,2668,Balıkesir,Susurluk
45-49,1399,1485,2884,Balıkesir,Susurluk
50-54,1496,1513,3009,Balıkesir,Susurluk
55-59,1481,1481,2962,Balıkesir,Susurluk
60-64,1228,1382,2610,Balıkesir,Susurluk
65-69,1042,1042,2084,Balıkesir,Susurluk
70-74,660,848,1508,Balıkesir,Susurluk
75+,1076,1715,2791,Balıkesir,Susurluk
18-24,2935,3119,6054,Konya,Karapınar
25-29,1689,1618,3307,Konya,Karapınar
30-34,1780,1623,3403,Konya,Karapınar
35-39,1782,1628,3410,Konya,Karapınar
40-44,1597,1544,3141,Konya,Karapınar
45-49,1543,1523,3066,Konya,Karapınar
50-54,1408,1443,2851,Konya,Karapınar
55-59,1101,1160,2261,Konya,Karapınar
60-64,947,1079,2026,Konya,Karapınar
65-69,702,858,1560,Konya,Karapınar
70-74,452,616,1068,Konya,Karapınar
75+,627,994,1621,Konya,Karapınar
18-24,611,724,1335,Niğde,Altunhisar
25-29,440,371,811,Niğde,Altunhisar
30-34,376,369,745,Niğde,Altunhisar
35-39,378,348,726,Niğde,Altunhisar
40-44,308,313,621,Niğde,Altunhisar
45-49,329,305,634,Niğde,Altunhisar
50-54,336,392,728,Niğde,Altunhisar
55-59,298,313,611,Niğde,Altunhisar
60-64,254,315,569,Niğde,Altunhisar
65-69,266,327,593,Niğde,Altunhisar
70-74,191,293,484,Niğde,Altunhisar
75+,346,594,940,Niğde,Altunhisar
18-24,1935,2079,4014,Mardin,Dargeçit
25-29,1206,1191,2397,Mardin,Dargeçit
30-34,789,832,1621,Mardin,Dargeçit
35-39,767,851,1618,Mardin,Dargeçit
40-44,538,737,1275,Mardin,Dargeçit
45-49,392,481,873,Mardin,Dargeçit
50-54,368,386,754,Mardin,Dargeçit
55-59,279,259,538,Mardin,Dargeçit
60-64,284,327,611,Mardin,Dargeçit
65-69,301,410,711,Mardin,Dargeçit
70-74,223,255,478,Mardin,Dargeçit
75+,323,477,800,Mardin,Dargeçit
18-24,3628,3583,7211,Antalya,Kumluca
25-29,2468,2442,4910,Antalya,Kumluca
30-34,2442,2581,5023,Antalya,Kumluca
35-39,2750,2837,5587,Antalya,Kumluca
40-44,2736,2670,5406,Antalya,Kumluca
45-49,2655,2586,5241,Antalya,Kumluca
50-54,2405,2096,4501,Antalya,Kumluca
55-59,2094,1939,4033,Antalya,Kumluca
60-64,1504,1448,2952,Antalya,Kumluca
65-69,1030,942,1972,Antalya,Kumluca
70-74,637,720,1357,Antalya,Kumluca
75+,1051,1305,2356,Antalya,Kumluca
18-24,536,537,1073,Çankırı,Ilgaz
25-29,375,329,704,Çankırı,Ilgaz
30-34,336,341,677,Çankırı,Ilgaz
35-39,417,337,754,Çankırı,Ilgaz
40-44,353,359,712,Çankırı,Ilgaz
45-49,405,361,766,Çankırı,Ilgaz
50-54,428,395,823,Çankırı,Ilgaz
55-59,540,581,1121,Çankırı,Ilgaz
60-64,612,629,1241,Çankırı,Ilgaz
65-69,548,601,1149,Çankırı,Ilgaz
70-74,385,468,853,Çankırı,Ilgaz
75+,664,901,1565,Çankırı,Ilgaz
18-24,1053,1074,2127,Çanakkale,Bayramiç
25-29,736,724,1460,Çanakkale,Bayramiç
30-34,887,844,1731,Çanakkale,Bayramiç
35-39,1022,996,2018,Çanakkale,Bayramiç
40-44,1007,941,1948,Çanakkale,Bayramiç
45-49,1021,1063,2084,Çanakkale,Bayramiç
50-54,1130,1098,2228,Çanakkale,Bayramiç
55-59,1108,1177,2285,Çanakkale,Bayramiç
60-64,1050,1093,2143,Çanakkale,Bayramiç
65-69,923,919,1842,Çanakkale,Bayramiç
70-74,617,782,1399,Çanakkale,Bayramiç
75+,1077,1459,2536,Çanakkale,Bayramiç
18-24,711,733,1444,Sakarya,Söğütlü
25-29,485,423,908,Sakarya,Söğütlü
30-34,516,446,962,Sakarya,Söğütlü
35-39,488,428,916,Sakarya,Söğütlü
40-44,489,403,892,Sakarya,Söğütlü
45-49,431,469,900,Sakarya,Söğütlü
50-54,456,477,933,Sakarya,Söğütlü
55-59,502,493,995,Sakarya,Söğütlü
60-64,378,429,807,Sakarya,Söğütlü
65-69,369,395,764,Sakarya,Söğütlü
70-74,242,249,491,Sakarya,Söğütlü
75+,368,502,870,Sakarya,Söğütlü
18-24,554,550,1104,Karabük,Eskipazar
25-29,348,293,641,Karabük,Eskipazar
30-34,363,262,625,Karabük,Eskipazar
35-39,349,314,663,Karabük,Eskipazar
40-44,312,286,598,Karabük,Eskipazar
45-49,389,375,764,Karabük,Eskipazar
50-54,432,449,881,Karabük,Eskipazar
55-59,460,492,952,Karabük,Eskipazar
60-64,498,483,981,Karabük,Eskipazar
65-69,410,447,857,Karabük,Eskipazar
70-74,292,389,681,Karabük,Eskipazar
75+,517,702,1219,Karabük,Eskipazar
18-24,15694,16182,31876,İstanbul,Zeytinburnu
25-29,11578,10811,22389,İstanbul,Zeytinburnu
30-34,11000,10670,21670,İstanbul,Zeytinburnu
35-39,11409,11126,22535,İstanbul,Zeytinburnu
40-44,10350,9855,20205,İstanbul,Zeytinburnu
45-49,9536,9095,18631,İstanbul,Zeytinburnu
50-54,8040,7764,15804,İstanbul,Zeytinburnu
55-59,6668,6323,12991,İstanbul,Zeytinburnu
60-64,4912,4969,9881,İstanbul,Zeytinburnu
65-69,3119,3404,6523,İstanbul,Zeytinburnu
70-74,1667,2177,3844,İstanbul,Zeytinburnu
75+,2043,3404,5447,İstanbul,Zeytinburnu
18-24,208,152,360,Bingöl,Yedisu
25-29,167,98,265,Bingöl,Yedisu
30-34,114,82,196,Bingöl,Yedisu
35-39,121,95,216,Bingöl,Yedisu
40-44,123,88,211,Bingöl,Yedisu
45-49,94,95,189,Bingöl,Yedisu
50-54,79,67,146,Bingöl,Yedisu
55-59,72,67,139,Bingöl,Yedisu
60-64,64,67,131,Bingöl,Yedisu
65-69,69,71,140,Bingöl,Yedisu
70-74,32,33,65,Bingöl,Yedisu
75+,56,71,127,Bingöl,Yedisu
18-24,669,612,1281,Aksaray,Güzelyurt
25-29,424,322,746,Aksaray,Güzelyurt
30-34,368,289,657,Aksaray,Güzelyurt
35-39,391,331,722,Aksaray,Güzelyurt
40-44,362,345,707,Aksaray,Güzelyurt
45-49,298,355,653,Aksaray,Güzelyurt
50-54,353,322,675,Aksaray,Güzelyurt
55-59,288,313,601,Aksaray,Güzelyurt
60-64,260,295,555,Aksaray,Güzelyurt
65-69,281,318,599,Aksaray,Güzelyurt
70-74,179,212,391,Aksaray,Güzelyurt
75+,272,381,653,Aksaray,Güzelyurt
18-24,7109,7434,14543,Aydın,Nazilli
25-29,5084,4971,10055,Aydın,Nazilli
30-34,5321,5261,10582,Aydın,Nazilli
35-39,5733,5845,11578,Aydın,Nazilli
40-44,5230,5342,10572,Aydın,Nazilli
45-49,4936,5185,10121,Aydın,Nazilli
50-54,4716,4816,9532,Aydın,Nazilli
55-59,4691,4972,9663,Aydın,Nazilli
60-64,4280,4548,8828,Aydın,Nazilli
65-69,3225,3407,6632,Aydın,Nazilli
70-74,2061,2632,4693,Aydın,Nazilli
75+,2893,4535,7428,Aydın,Nazilli
18-24,553,461,1014,Isparta,Keçiborlu
25-29,344,327,671,Isparta,Keçiborlu
30-34,400,379,779,Isparta,Keçiborlu
35-39,490,421,911,Isparta,Keçiborlu
40-44,442,423,865,Isparta,Keçiborlu
45-49,383,406,789,Isparta,Keçiborlu
50-54,455,497,952,Isparta,Keçiborlu
55-59,545,638,1183,Isparta,Keçiborlu
60-64,476,565,1041,Isparta,Keçiborlu
65-69,504,556,1060,Isparta,Keçiborlu
70-74,308,354,662,Isparta,Keçiborlu
75+,495,743,1238,Isparta,Keçiborlu
18-24,20561,21085,41646,İstanbul,Ataşehir
25-29,15940,16632,32572,İstanbul,Ataşehir
30-34,17655,18402,36057,İstanbul,Ataşehir
35-39,19467,19980,39447,İstanbul,Ataşehir
40-44,17425,18236,35661,İstanbul,Ataşehir
45-49,15334,15683,31017,İstanbul,Ataşehir
50-54,13124,12828,25952,İstanbul,Ataşehir
55-59,10250,10105,20355,İstanbul,Ataşehir
60-64,7813,7995,15808,İstanbul,Ataşehir
65-69,5265,5836,11101,İstanbul,Ataşehir
70-74,3244,3989,7233,İstanbul,Ataşehir
75+,3747,5850,9597,İstanbul,Ataşehir
18-24,452,363,815,Elazığ,Alacakaya
25-29,267,197,464,Elazığ,Alacakaya
30-34,228,179,407,Elazığ,Alacakaya
35-39,225,207,432,Elazığ,Alacakaya
40-44,195,218,413,Elazığ,Alacakaya
45-49,236,202,438,Elazığ,Alacakaya
50-54,198,183,381,Elazığ,Alacakaya
55-59,153,190,343,Elazığ,Alacakaya
60-64,151,141,292,Elazığ,Alacakaya
65-69,106,105,211,Elazığ,Alacakaya
70-74,61,101,162,Elazığ,Alacakaya
75+,151,193,344,Elazığ,Alacakaya
18-24,3853,3879,7732,Şanlıurfa,Bozova
25-29,2139,2083,4222,Şanlıurfa,Bozova
30-34,1709,1645,3354,Şanlıurfa,Bozova
35-39,1432,1512,2944,Şanlıurfa,Bozova
40-44,1270,1396,2666,Şanlıurfa,Bozova
45-49,1129,978,2107,Şanlıurfa,Bozova
50-54,1050,1071,2121,Şanlıurfa,Bozova
55-59,745,842,1587,Şanlıurfa,Bozova
60-64,660,700,1360,Şanlıurfa,Bozova
65-69,543,727,1270,Şanlıurfa,Bozova
70-74,421,580,1001,Şanlıurfa,Bozova
75+,588,1096,1684,Şanlıurfa,Bozova
18-24,404,356,760,Balıkesir,Marmara
25-29,373,316,689,Balıkesir,Marmara
30-34,323,277,600,Balıkesir,Marmara
35-39,365,259,624,Balıkesir,Marmara
40-44,337,307,644,Balıkesir,Marmara
45-49,358,280,638,Balıkesir,Marmara
50-54,340,338,678,Balıkesir,Marmara
55-59,401,359,760,Balıkesir,Marmara
60-64,373,368,741,Balıkesir,Marmara
65-69,310,279,589,Balıkesir,Marmara
70-74,255,238,493,Balıkesir,Marmara
75+,329,335,664,Balıkesir,Marmara
18-24,365,353,718,Çanakkale,Gökçeada
25-29,337,280,617,Çanakkale,Gökçeada
30-34,329,319,648,Çanakkale,Gökçeada
35-39,354,339,693,Çanakkale,Gökçeada
40-44,345,263,608,Çanakkale,Gökçeada
45-49,263,209,472,Çanakkale,Gökçeada
50-54,219,212,431,Çanakkale,Gökçeada
55-59,227,218,445,Çanakkale,Gökçeada
60-64,225,219,444,Çanakkale,Gökçeada
65-69,179,191,370,Çanakkale,Gökçeada
70-74,121,132,253,Çanakkale,Gökçeada
75+,195,209,404,Çanakkale,Gökçeada
18-24,2097,2201,4298,Sakarya,Sapanca
25-29,1427,1453,2880,Sakarya,Sapanca
30-34,1446,1473,2919,Sakarya,Sapanca
35-39,1540,1535,3075,Sakarya,Sapanca
40-44,1482,1491,2973,Sakarya,Sapanca
45-49,1381,1429,2810,Sakarya,Sapanca
50-54,1298,1230,2528,Sakarya,Sapanca
55-59,1150,1201,2351,Sakarya,Sapanca
60-64,988,969,1957,Sakarya,Sapanca
65-69,718,716,1434,Sakarya,Sapanca
70-74,507,509,1016,Sakarya,Sapanca
75+,556,810,1366,Sakarya,Sapanca
18-24,1393,1262,2655,Adıyaman,Gerger
25-29,640,523,1163,Adıyaman,Gerger
30-34,477,477,954,Adıyaman,Gerger
35-39,462,445,907,Adıyaman,Gerger
40-44,335,399,734,Adıyaman,Gerger
45-49,381,369,750,Adıyaman,Gerger
50-54,312,349,661,Adıyaman,Gerger
55-59,314,352,666,Adıyaman,Gerger
60-64,282,353,635,Adıyaman,Gerger
65-69,286,420,706,Adıyaman,Gerger
70-74,269,311,580,Adıyaman,Gerger
75+,509,685,1194,Adıyaman,Gerger
18-24,12441,13028,25469,Mersin,Yenişehir
25-29,8437,9192,17629,Mersin,Yenişehir
30-34,8732,9979,18711,Mersin,Yenişehir
35-39,9725,11207,20932,Mersin,Yenişehir
40-44,9110,10352,19462,Mersin,Yenişehir
45-49,8365,9074,17439,Mersin,Yenişehir
50-54,7671,8251,15922,Mersin,Yenişehir
55-59,6569,6803,13372,Mersin,Yenişehir
60-64,5379,5532,10911,Mersin,Yenişehir
65-69,3725,4084,7809,Mersin,Yenişehir
70-74,2419,2820,5239,Mersin,Yenişehir
75+,2636,3688,6324,Mersin,Yenişehir
18-24,454,486,940,Ardahan,Çıldır
25-29,305,267,572,Ardahan,Çıldır
30-34,292,266,558,Ardahan,Çıldır
35-39,348,264,612,Ardahan,Çıldır
40-44,340,268,608,Ardahan,Çıldır
45-49,289,277,566,Ardahan,Çıldır
50-54,303,259,562,Ardahan,Çıldır
55-59,302,264,566,Ardahan,Çıldır
60-64,223,240,463,Ardahan,Çıldır
65-69,202,238,440,Ardahan,Çıldır
70-74,215,227,442,Ardahan,Çıldır
75+,293,363,656,Ardahan,Çıldır
18-24,1005,1053,2058,Erzurum,Köprüköy
25-29,597,480,1077,Erzurum,Köprüköy
30-34,513,485,998,Erzurum,Köprüköy
35-39,498,527,1025,Erzurum,Köprüköy
40-44,475,402,877,Erzurum,Köprüköy
45-49,416,340,756,Erzurum,Köprüköy
50-54,317,294,611,Erzurum,Köprüköy
55-59,249,239,488,Erzurum,Köprüköy
60-64,209,247,456,Erzurum,Köprüköy
65-69,187,186,373,Erzurum,Köprüköy
70-74,115,191,306,Erzurum,Köprüköy
75+,177,261,438,Erzurum,Köprüköy
18-24,3256,3269,6525,Kocaeli,Dilovası
25-29,2385,2089,4474,Kocaeli,Dilovası
30-34,2006,1735,3741,Kocaeli,Dilovası
35-39,1956,1800,3756,Kocaeli,Dilovası
40-44,1537,1337,2874,Kocaeli,Dilovası
45-49,1348,1149,2497,Kocaeli,Dilovası
50-54,1095,985,2080,Kocaeli,Dilovası
55-59,895,788,1683,Kocaeli,Dilovası
60-64,640,629,1269,Kocaeli,Dilovası
65-69,396,490,886,Kocaeli,Dilovası
70-74,260,318,578,Kocaeli,Dilovası
75+,304,442,746,Kocaeli,Dilovası
18-24,4876,5083,9959,Manisa,Alaşehir
25-29,3145,3152,6297,Manisa,Alaşehir
30-34,3569,3637,7206,Manisa,Alaşehir
35-39,3873,3728,7601,Manisa,Alaşehir
40-44,3709,3498,7207,Manisa,Alaşehir
45-49,3627,3486,7113,Manisa,Alaşehir
50-54,3398,3471,6869,Manisa,Alaşehir
55-59,3385,3144,6529,Manisa,Alaşehir
60-64,2692,2756,5448,Manisa,Alaşehir
65-69,1983,2172,4155,Manisa,Alaşehir
70-74,1278,1628,2906,Manisa,Alaşehir
75+,1864,2673,4537,Manisa,Alaşehir
18-24,319,270,589,Erzincan,Kemah
25-29,227,115,342,Erzincan,Kemah
30-34,153,135,288,Erzincan,Kemah
35-39,163,108,271,Erzincan,Kemah
40-44,171,137,308,Erzincan,Kemah
45-49,168,131,299,Erzincan,Kemah
50-54,182,191,373,Erzincan,Kemah
55-59,279,268,547,Erzincan,Kemah
60-64,333,339,672,Erzincan,Kemah
65-69,311,333,644,Erzincan,Kemah
70-74,232,303,535,Erzincan,Kemah
75+,453,613,1066,Erzincan,Kemah
18-24,1242,1244,2486,Diyarbakır,Kocaköy
25-29,826,668,1494,Diyarbakır,Kocaköy
30-34,542,525,1067,Diyarbakır,Kocaköy
35-39,469,498,967,Diyarbakır,Kocaköy
40-44,373,413,786,Diyarbakır,Kocaköy
45-49,316,302,618,Diyarbakır,Kocaköy
50-54,302,284,586,Diyarbakır,Kocaköy
55-59,215,230,445,Diyarbakır,Kocaköy
60-64,185,176,361,Diyarbakır,Kocaköy
65-69,146,157,303,Diyarbakır,Kocaköy
70-74,102,133,235,Diyarbakır,Kocaköy
75+,141,237,378,Diyarbakır,Kocaköy
18-24,6259,5966,12225,Şırnak,Şırnak Merkez
25-29,6317,4085,10402,Şırnak,Şırnak Merkez
30-34,3573,2701,6274,Şırnak,Şırnak Merkez
35-39,2811,2707,5518,Şırnak,Şırnak Merkez
40-44,1634,1662,3296,Şırnak,Şırnak Merkez
45-49,1326,1183,2509,Şırnak,Şırnak Merkez
50-54,1229,1017,2246,Şırnak,Şırnak Merkez
55-59,750,633,1383,Şırnak,Şırnak Merkez
60-64,603,649,1252,Şırnak,Şırnak Merkez
65-69,356,531,887,Şırnak,Şırnak Merkez
70-74,267,403,670,Şırnak,Şırnak Merkez
75+,395,626,1021,Şırnak,Şırnak Merkez
18-24,1788,1905,3693,Yozgat,Sarıkaya
25-29,1088,1002,2090,Yozgat,Sarıkaya
30-34,1089,938,2027,Yozgat,Sarıkaya
35-39,1015,961,1976,Yozgat,Sarıkaya
40-44,884,929,1813,Yozgat,Sarıkaya
45-49,940,935,1875,Yozgat,Sarıkaya
50-54,951,1064,2015,Yozgat,Sarıkaya
55-59,995,921,1916,Yozgat,Sarıkaya
60-64,934,954,1888,Yozgat,Sarıkaya
65-69,757,905,1662,Yozgat,Sarıkaya
70-74,537,759,1296,Yozgat,Sarıkaya
75+,762,1063,1825,Yozgat,Sarıkaya
18-24,700,761,1461,Denizli,Serinhisar
25-29,424,436,860,Denizli,Serinhisar
30-34,446,440,886,Denizli,Serinhisar
35-39,532,467,999,Denizli,Serinhisar
40-44,487,479,966,Denizli,Serinhisar
45-49,503,465,968,Denizli,Serinhisar
50-54,512,445,957,Denizli,Serinhisar
55-59,446,452,898,Denizli,Serinhisar
60-64,364,394,758,Denizli,Serinhisar
65-69,348,399,747,Denizli,Serinhisar
70-74,222,341,563,Denizli,Serinhisar
75+,348,631,979,Denizli,Serinhisar
18-24,1550,1536,3086,Giresun,Tirebolu
25-29,859,861,1720,Giresun,Tirebolu
30-34,872,846,1718,Giresun,Tirebolu
35-39,920,962,1882,Giresun,Tirebolu
40-44,957,871,1828,Giresun,Tirebolu
45-49,1012,1002,2014,Giresun,Tirebolu
50-54,1140,1163,2303,Giresun,Tirebolu
55-59,1230,1077,2307,Giresun,Tirebolu
60-64,1204,1146,2350,Giresun,Tirebolu
65-69,797,789,1586,Giresun,Tirebolu
70-74,469,672,1141,Giresun,Tirebolu
75+,1014,1591,2605,Giresun,Tirebolu
18-24,1816,1871,3687,Düzce,Akçakoca
25-29,1120,1119,2239,Düzce,Akçakoca
30-34,1123,1190,2313,Düzce,Akçakoca
35-39,1315,1353,2668,Düzce,Akçakoca
40-44,1338,1361,2699,Düzce,Akçakoca
45-49,1415,1422,2837,Düzce,Akçakoca
50-54,1388,1461,2849,Düzce,Akçakoca
55-59,1360,1414,2774,Düzce,Akçakoca
60-64,1255,1169,2424,Düzce,Akçakoca
65-69,879,889,1768,Düzce,Akçakoca
70-74,602,679,1281,Düzce,Akçakoca
75+,769,1194,1963,Düzce,Akçakoca
18-24,383,361,744,Tunceli,Çemişgezek
25-29,294,239,533,Tunceli,Çemişgezek
30-34,295,254,549,Tunceli,Çemişgezek
35-39,293,240,533,Tunceli,Çemişgezek
40-44,290,222,512,Tunceli,Çemişgezek
45-49,264,223,487,Tunceli,Çemişgezek
50-54,207,252,459,Tunceli,Çemişgezek
55-59,214,221,435,Tunceli,Çemişgezek
60-64,213,237,450,Tunceli,Çemişgezek
65-69,195,212,407,Tunceli,Çemişgezek
70-74,128,175,303,Tunceli,Çemişgezek
75+,275,351,626,Tunceli,Çemişgezek
18-24,2672,2926,5598,Konya,Kulu
25-29,1709,1699,3408,Konya,Kulu
30-34,1795,1634,3429,Konya,Kulu
35-39,1692,1606,3298,Konya,Kulu
40-44,1371,1458,2829,Konya,Kulu
45-49,1341,1395,2736,Konya,Kulu
50-54,1334,1403,2737,Konya,Kulu
55-59,1326,1448,2774,Konya,Kulu
60-64,1207,1376,2583,Konya,Kulu
65-69,936,1134,2070,Konya,Kulu
70-74,598,760,1358,Konya,Kulu
75+,753,1209,1962,Konya,Kulu
18-24,4935,5430,10365,Manisa,Soma
25-29,3945,4301,8246,Manisa,Soma
30-34,4883,4670,9553,Manisa,Soma
35-39,5147,4797,9944,Manisa,Soma
40-44,4091,3862,7953,Manisa,Soma
45-49,3525,3613,7138,Manisa,Soma
50-54,3273,3430,6703,Manisa,Soma
55-59,3118,3071,6189,Manisa,Soma
60-64,2476,2314,4790,Manisa,Soma
65-69,1664,1714,3378,Manisa,Soma
70-74,1027,1238,2265,Manisa,Soma
75+,1336,1990,3326,Manisa,Soma
18-24,173,166,339,Amasya,Hamamözü
25-29,88,87,175,Amasya,Hamamözü
30-34,83,85,168,Amasya,Hamamözü
35-39,95,95,190,Amasya,Hamamözü
40-44,82,96,178,Amasya,Hamamözü
45-49,117,120,237,Amasya,Hamamözü
50-54,125,117,242,Amasya,Hamamözü
55-59,128,144,272,Amasya,Hamamözü
60-64,122,142,264,Amasya,Hamamözü
65-69,129,162,291,Amasya,Hamamözü
70-74,117,156,273,Amasya,Hamamözü
75+,214,234,448,Amasya,Hamamözü
18-24,548,469,1017,Elazığ,Maden
25-29,359,298,657,Elazığ,Maden
30-34,359,290,649,Elazığ,Maden
35-39,331,355,686,Elazığ,Maden
40-44,299,319,618,Elazığ,Maden
45-49,329,380,709,Elazığ,Maden
50-54,355,421,776,Elazığ,Maden
55-59,323,384,707,Elazığ,Maden
60-64,333,358,691,Elazığ,Maden
65-69,255,320,575,Elazığ,Maden
70-74,210,273,483,Elazığ,Maden
75+,403,462,865,Elazığ,Maden
18-24,1503,1389,2892,Iğdır,Tuzluca
25-29,876,732,1608,Iğdır,Tuzluca
30-34,748,646,1394,Iğdır,Tuzluca
35-39,813,743,1556,Iğdır,Tuzluca
40-44,623,570,1193,Iğdır,Tuzluca
45-49,550,474,1024,Iğdır,Tuzluca
50-54,478,461,939,Iğdır,Tuzluca
55-59,534,473,1007,Iğdır,Tuzluca
60-64,450,538,988,Iğdır,Tuzluca
65-69,382,426,808,Iğdır,Tuzluca
70-74,288,289,577,Iğdır,Tuzluca
75+,364,407,771,Iğdır,Tuzluca
18-24,1024,1134,2158,Gümüşhane,Şiran
25-29,599,553,1152,Gümüşhane,Şiran
30-34,595,488,1083,Gümüşhane,Şiran
35-39,618,543,1161,Gümüşhane,Şiran
40-44,635,570,1205,Gümüşhane,Şiran
45-49,553,537,1090,Gümüşhane,Şiran
50-54,546,544,1090,Gümüşhane,Şiran
55-59,574,564,1138,Gümüşhane,Şiran
60-64,620,614,1234,Gümüşhane,Şiran
65-69,462,509,971,Gümüşhane,Şiran
70-74,364,437,801,Gümüşhane,Şiran
75+,717,929,1646,Gümüşhane,Şiran
18-24,54690,56931,111621,Gaziantep,Şahinbey
25-29,34985,36127,71112,Gaziantep,Şahinbey
30-34,35868,34673,70541,Gaziantep,Şahinbey
35-39,34707,32895,67602,Gaziantep,Şahinbey
40-44,28569,27095,55664,Gaziantep,Şahinbey
45-49,22906,21669,44575,Gaziantep,Şahinbey
50-54,19304,18217,37521,Gaziantep,Şahinbey
55-59,14482,14658,29140,Gaziantep,Şahinbey
60-64,10337,10615,20952,Gaziantep,Şahinbey
65-69,7791,8357,16148,Gaziantep,Şahinbey
70-74,4916,5929,10845,Gaziantep,Şahinbey
75+,5323,8815,14138,Gaziantep,Şahinbey
18-24,2095,2214,4309,Siirt,Pervari
25-29,1149,993,2142,Siirt,Pervari
30-34,789,797,1586,Siirt,Pervari
35-39,661,771,1432,Siirt,Pervari
40-44,637,576,1213,Siirt,Pervari
45-49,535,519,1054,Siirt,Pervari
50-54,468,445,913,Siirt,Pervari
55-59,354,341,695,Siirt,Pervari
60-64,314,310,624,Siirt,Pervari
65-69,214,281,495,Siirt,Pervari
70-74,139,212,351,Siirt,Pervari
75+,196,309,505,Siirt,Pervari
18-24,1807,1749,3556,Konya,Kadınhanı
25-29,1074,963,2037,Konya,Kadınhanı
30-34,1055,913,1968,Konya,Kadınhanı
35-39,1020,964,1984,Konya,Kadınhanı
40-44,912,900,1812,Konya,Kadınhanı
45-49,1000,972,1972,Konya,Kadınhanı
50-54,941,1025,1966,Konya,Kadınhanı
55-59,879,910,1789,Konya,Kadınhanı
60-64,610,721,1331,Konya,Kadınhanı
65-69,615,682,1297,Konya,Kadınhanı
70-74,395,546,941,Konya,Kadınhanı
75+,501,717,1218,Konya,Kadınhanı
18-24,265,271,536,Malatya,Kale
25-29,116,139,255,Malatya,Kale
30-34,119,137,256,Malatya,Kale
35-39,163,152,315,Malatya,Kale
40-44,167,167,334,Malatya,Kale
45-49,137,175,312,Malatya,Kale
50-54,166,176,342,Malatya,Kale
55-59,202,201,403,Malatya,Kale
60-64,221,199,420,Malatya,Kale
65-69,160,205,365,Malatya,Kale
70-74,159,173,332,Malatya,Kale
75+,238,353,591,Malatya,Kale
18-24,12358,12452,24810,Kütahya,Kütahya Merkez
25-29,8856,8872,17728,Kütahya,Kütahya Merkez
30-34,9660,9765,19425,Kütahya,Kütahya Merkez
35-39,9896,10134,20030,Kütahya,Kütahya Merkez
40-44,9306,9715,19021,Kütahya,Kütahya Merkez
45-49,8302,8567,16869,Kütahya,Kütahya Merkez
50-54,7447,7518,14965,Kütahya,Kütahya Merkez
55-59,6895,7155,14050,Kütahya,Kütahya Merkez
60-64,5511,5559,11070,Kütahya,Kütahya Merkez
65-69,4304,4608,8912,Kütahya,Kütahya Merkez
70-74,2671,3265,5936,Kütahya,Kütahya Merkez
75+,3434,4826,8260,Kütahya,Kütahya Merkez
18-24,5435,5604,11039,Zonguldak,Zonguldak Merkez
25-29,3591,3687,7278,Zonguldak,Zonguldak Merkez
30-34,4177,4151,8328,Zonguldak,Zonguldak Merkez
35-39,4884,4840,9724,Zonguldak,Zonguldak Merkez
40-44,4429,4544,8973,Zonguldak,Zonguldak Merkez
45-49,4117,4285,8402,Zonguldak,Zonguldak Merkez
50-54,3865,4351,8216,Zonguldak,Zonguldak Merkez
55-59,4091,4333,8424,Zonguldak,Zonguldak Merkez
60-64,3600,3467,7067,Zonguldak,Zonguldak Merkez
65-69,2392,2459,4851,Zonguldak,Zonguldak Merkez
70-74,1393,1711,3104,Zonguldak,Zonguldak Merkez
75+,1793,3005,4798,Zonguldak,Zonguldak Merkez
18-24,319,283,602,Malatya,Arguvan
25-29,184,161,345,Malatya,Arguvan
30-34,171,159,330,Malatya,Arguvan
35-39,245,149,394,Malatya,Arguvan
40-44,215,193,408,Malatya,Arguvan
45-49,219,253,472,Malatya,Arguvan
50-54,288,229,517,Malatya,Arguvan
55-59,313,261,574,Malatya,Arguvan
60-64,266,273,539,Malatya,Arguvan
65-69,297,306,603,Malatya,Arguvan
70-74,237,314,551,Malatya,Arguvan
75+,416,632,1048,Malatya,Arguvan
18-24,1053,1102,2155,Ankara,Nallıhan
25-29,885,898,1783,Ankara,Nallıhan
30-34,1092,896,1988,Ankara,Nallıhan
35-39,1012,911,1923,Ankara,Nallıhan
40-44,883,821,1704,Ankara,Nallıhan
45-49,839,845,1684,Ankara,Nallıhan
50-54,864,878,1742,Ankara,Nallıhan
55-59,986,1141,2127,Ankara,Nallıhan
60-64,961,1030,1991,Ankara,Nallıhan
65-69,813,878,1691,Ankara,Nallıhan
70-74,579,707,1286,Ankara,Nallıhan
75+,1028,1480,2508,Ankara,Nallıhan
18-24,85,103,188,Sivas,Gölova
25-29,77,64,141,Sivas,Gölova
30-34,85,73,158,Sivas,Gölova
35-39,77,54,131,Sivas,Gölova
40-44,73,50,123,Sivas,Gölova
45-49,72,48,120,Sivas,Gölova
50-54,89,69,158,Sivas,Gölova
55-59,111,125,236,Sivas,Gölova
60-64,178,200,378,Sivas,Gölova
65-69,155,180,335,Sivas,Gölova
70-74,135,159,294,Sivas,Gölova
75+,193,258,451,Sivas,Gölova
18-24,3508,3342,6850,Bitlis,Güroymak
25-29,1984,1905,3889,Bitlis,Güroymak
30-34,1486,1229,2715,Bitlis,Güroymak
35-39,1617,1507,3124,Bitlis,Güroymak
40-44,1104,1049,2153,Bitlis,Güroymak
45-49,989,802,1791,Bitlis,Güroymak
50-54,887,717,1604,Bitlis,Güroymak
55-59,585,495,1080,Bitlis,Güroymak
60-64,440,463,903,Bitlis,Güroymak
65-69,276,402,678,Bitlis,Güroymak
70-74,190,240,430,Bitlis,Güroymak
75+,233,431,664,Bitlis,Güroymak
18-24,16303,16014,32317,İstanbul,Sarıyer
25-29,12157,11958,24115,İstanbul,Sarıyer
30-34,12986,13290,26276,İstanbul,Sarıyer
35-39,14669,15661,30330,İstanbul,Sarıyer
40-44,13968,14530,28498,İstanbul,Sarıyer
45-49,12889,13145,26034,İstanbul,Sarıyer
50-54,11069,11111,22180,İstanbul,Sarıyer
55-59,8856,8985,17841,İstanbul,Sarıyer
60-64,6693,7280,13973,İstanbul,Sarıyer
65-69,4907,5485,10392,İstanbul,Sarıyer
70-74,3272,3793,7065,İstanbul,Sarıyer
75+,3942,5977,9919,İstanbul,Sarıyer
18-24,525,612,1137,Ankara,Ayaş
25-29,411,322,733,Ankara,Ayaş
30-34,338,290,628,Ankara,Ayaş
35-39,350,334,684,Ankara,Ayaş
40-44,351,348,699,Ankara,Ayaş
45-49,415,400,815,Ankara,Ayaş
50-54,446,442,888,Ankara,Ayaş
55-59,506,486,992,Ankara,Ayaş
60-64,460,490,950,Ankara,Ayaş
65-69,340,383,723,Ankara,Ayaş
70-74,272,305,577,Ankara,Ayaş
75+,411,590,1001,Ankara,Ayaş
18-24,2545,2665,5210,Sinop,Sinop Merkez
25-29,2025,1797,3822,Sinop,Sinop Merkez
30-34,2103,2095,4198,Sinop,Sinop Merkez
35-39,2233,2362,4595,Sinop,Sinop Merkez
40-44,1986,2092,4078,Sinop,Sinop Merkez
45-49,1843,2106,3949,Sinop,Sinop Merkez
50-54,1953,2075,4028,Sinop,Sinop Merkez
55-59,1947,2004,3951,Sinop,Sinop Merkez
60-64,1828,1829,3657,Sinop,Sinop Merkez
65-69,1419,1411,2830,Sinop,Sinop Merkez
70-74,993,1151,2144,Sinop,Sinop Merkez
75+,1281,1986,3267,Sinop,Sinop Merkez
18-24,149,131,280,Çankırı,Atkaracalar
25-29,108,113,221,Çankırı,Atkaracalar
30-34,121,121,242,Çankırı,Atkaracalar
35-39,117,100,217,Çankırı,Atkaracalar
40-44,127,87,214,Çankırı,Atkaracalar
45-49,103,101,204,Çankırı,Atkaracalar
50-54,123,141,264,Çankırı,Atkaracalar
55-59,163,146,309,Çankırı,Atkaracalar
60-64,190,186,376,Çankırı,Atkaracalar
65-69,152,172,324,Çankırı,Atkaracalar
70-74,127,132,259,Çankırı,Atkaracalar
75+,164,201,365,Çankırı,Atkaracalar
18-24,6958,7347,14305,Hatay,Dörtyol
25-29,4264,4626,8890,Hatay,Dörtyol
30-34,4606,4711,9317,Hatay,Dörtyol
35-39,4811,4917,9728,Hatay,Dörtyol
40-44,4151,4194,8345,Hatay,Dörtyol
45-49,3844,3581,7425,Hatay,Dörtyol
50-54,3340,3212,6552,Hatay,Dörtyol
55-59,2841,2811,5652,Hatay,Dörtyol
60-64,2227,2261,4488,Hatay,Dörtyol
65-69,1740,1627,3367,Hatay,Dörtyol
70-74,940,1090,2030,Hatay,Dörtyol
75+,1070,1520,2590,Hatay,Dörtyol
18-24,619,609,1228,Artvin,Şavşat
25-29,388,325,713,Artvin,Şavşat
30-34,350,272,622,Artvin,Şavşat
35-39,380,348,728,Artvin,Şavşat
40-44,403,410,813,Artvin,Şavşat
45-49,530,522,1052,Artvin,Şavşat
50-54,649,581,1230,Artvin,Şavşat
55-59,709,690,1399,Artvin,Şavşat
60-64,924,973,1897,Artvin,Şavşat
65-69,989,986,1975,Artvin,Şavşat
70-74,659,846,1505,Artvin,Şavşat
75+,1146,1316,2462,Artvin,Şavşat
18-24,1321,1281,2602,Mersin,Bozyazı
25-29,684,722,1406,Mersin,Bozyazı
30-34,860,852,1712,Mersin,Bozyazı
35-39,1077,1082,2159,Mersin,Bozyazı
40-44,1126,1113,2239,Mersin,Bozyazı
45-49,1063,1001,2064,Mersin,Bozyazı
50-54,953,965,1918,Mersin,Bozyazı
55-59,779,811,1590,Mersin,Bozyazı
60-64,636,703,1339,Mersin,Bozyazı
65-69,531,566,1097,Mersin,Bozyazı
70-74,405,452,857,Mersin,Bozyazı
75+,621,701,1322,Mersin,Bozyazı
18-24,824,757,1581,Erzurum,Tortum
25-29,462,435,897,Erzurum,Tortum
30-34,387,344,731,Erzurum,Tortum
35-39,397,352,749,Erzurum,Tortum
40-44,382,353,735,Erzurum,Tortum
45-49,395,464,859,Erzurum,Tortum
50-54,418,470,888,Erzurum,Tortum
55-59,463,578,1041,Erzurum,Tortum
60-64,481,590,1071,Erzurum,Tortum
65-69,427,505,932,Erzurum,Tortum
70-74,413,461,874,Erzurum,Tortum
75+,740,854,1594,Erzurum,Tortum
18-24,1058,993,2051,Muğla,Ula
25-29,832,710,1542,Muğla,Ula
30-34,798,753,1551,Muğla,Ula
35-39,954,898,1852,Muğla,Ula
40-44,887,909,1796,Muğla,Ula
45-49,918,874,1792,Muğla,Ula
50-54,900,895,1795,Muğla,Ula
55-59,905,909,1814,Muğla,Ula
60-64,838,888,1726,Muğla,Ula
65-69,679,705,1384,Muğla,Ula
70-74,513,498,1011,Muğla,Ula
75+,849,1051,1900,Muğla,Ula
18-24,1200,1230,2430,Tokat,Reşadiye
25-29,761,704,1465,Tokat,Reşadiye
30-34,779,725,1504,Tokat,Reşadiye
35-39,819,644,1463,Tokat,Reşadiye
40-44,715,718,1433,Tokat,Reşadiye
45-49,732,761,1493,Tokat,Reşadiye
50-54,855,948,1803,Tokat,Reşadiye
55-59,1077,1108,2185,Tokat,Reşadiye
60-64,1186,1389,2575,Tokat,Reşadiye
65-69,1019,1177,2196,Tokat,Reşadiye
70-74,787,950,1737,Tokat,Reşadiye
75+,1211,1551,2762,Tokat,Reşadiye
18-24,4245,4299,8544,Kırklareli,Kırklareli Merkez
25-29,3470,3100,6570,Kırklareli,Kırklareli Merkez
30-34,3506,3070,6576,Kırklareli,Kırklareli Merkez
35-39,3612,3450,7062,Kırklareli,Kırklareli Merkez
40-44,3412,3192,6604,Kırklareli,Kırklareli Merkez
45-49,3054,3041,6095,Kırklareli,Kırklareli Merkez
50-54,2998,3101,6099,Kırklareli,Kırklareli Merkez
55-59,3160,3120,6280,Kırklareli,Kırklareli Merkez
60-64,2896,2970,5866,Kırklareli,Kırklareli Merkez
65-69,2104,2130,4234,Kırklareli,Kırklareli Merkez
70-74,1347,1570,2917,Kırklareli,Kırklareli Merkez
75+,1869,2797,4666,Kırklareli,Kırklareli Merkez
18-24,182,129,311,Kastamonu,Abana
25-29,86,93,179,Kastamonu,Abana
30-34,127,117,244,Kastamonu,Abana
35-39,102,113,215,Kastamonu,Abana
40-44,92,95,187,Kastamonu,Abana
45-49,100,100,200,Kastamonu,Abana
50-54,118,157,275,Kastamonu,Abana
55-59,194,186,380,Kastamonu,Abana
60-64,191,184,375,Kastamonu,Abana
65-69,160,164,324,Kastamonu,Abana
70-74,104,117,221,Kastamonu,Abana
75+,171,211,382,Kastamonu,Abana
18-24,1372,1298,2670,Ordu,Perşembe
25-29,778,628,1406,Ordu,Perşembe
30-34,661,538,1199,Ordu,Perşembe
35-39,716,760,1476,Ordu,Perşembe
40-44,827,886,1713,Ordu,Perşembe
45-49,1005,1099,2104,Ordu,Perşembe
50-54,1391,1305,2696,Ordu,Perşembe
55-59,1344,1226,2570,Ordu,Perşembe
60-64,1344,1372,2716,Ordu,Perşembe
65-69,966,986,1952,Ordu,Perşembe
70-74,754,914,1668,Ordu,Perşembe
75+,1436,2033,3469,Ordu,Perşembe
18-24,856,887,1743,Balıkesir,Kepsut
25-29,509,459,968,Balıkesir,Kepsut
30-34,498,451,949,Balıkesir,Kepsut
35-39,647,540,1187,Balıkesir,Kepsut
40-44,716,676,1392,Balıkesir,Kepsut
45-49,771,769,1540,Balıkesir,Kepsut
50-54,784,839,1623,Balıkesir,Kepsut
55-59,781,880,1661,Balıkesir,Kepsut
60-64,756,855,1611,Balıkesir,Kepsut
65-69,742,788,1530,Balıkesir,Kepsut
70-74,486,624,1110,Balıkesir,Kepsut
75+,807,1151,1958,Balıkesir,Kepsut
18-24,1759,1728,3487,Ordu,Korgan
25-29,943,843,1786,Ordu,Korgan
30-34,1002,873,1875,Ordu,Korgan
35-39,994,854,1848,Ordu,Korgan
40-44,867,836,1703,Ordu,Korgan
45-49,828,770,1598,Ordu,Korgan
50-54,903,965,1868,Ordu,Korgan
55-59,776,807,1583,Ordu,Korgan
60-64,819,853,1672,Ordu,Korgan
65-69,581,685,1266,Ordu,Korgan
70-74,464,558,1022,Ordu,Korgan
75+,690,798,1488,Ordu,Korgan
18-24,3444,3396,6840,İstanbul,Çatalca
25-29,2514,2356,4870,İstanbul,Çatalca
30-34,2624,2512,5136,İstanbul,Çatalca
35-39,2789,2652,5441,İstanbul,Çatalca
40-44,2568,2391,4959,İstanbul,Çatalca
45-49,2585,2382,4967,İstanbul,Çatalca
50-54,2433,2419,4852,İstanbul,Çatalca
55-59,2319,2182,4501,İstanbul,Çatalca
60-64,1993,1909,3902,İstanbul,Çatalca
65-69,1530,1462,2992,İstanbul,Çatalca
70-74,980,1056,2036,İstanbul,Çatalca
75+,1279,1726,3005,İstanbul,Çatalca
18-24,1867,2183,4050,Van,Gevaş
25-29,1218,1187,2405,Van,Gevaş
30-34,1006,861,1867,Van,Gevaş
35-39,878,979,1857,Van,Gevaş
40-44,664,651,1315,Van,Gevaş
45-49,651,666,1317,Van,Gevaş
50-54,673,576,1249,Van,Gevaş
55-59,523,478,1001,Van,Gevaş
60-64,392,403,795,Van,Gevaş
65-69,302,408,710,Van,Gevaş
70-74,189,266,455,Van,Gevaş
75+,276,365,641,Van,Gevaş
18-24,6094,7104,13198,Hatay,Samandağ
25-29,3101,3931,7032,Hatay,Samandağ
30-34,3158,4327,7485,Hatay,Samandağ
35-39,4049,4773,8822,Hatay,Samandağ
40-44,4064,4370,8434,Hatay,Samandağ
45-49,3961,4024,7985,Hatay,Samandağ
50-54,3651,3626,7277,Hatay,Samandağ
55-59,3230,2991,6221,Hatay,Samandağ
60-64,2341,2399,4740,Hatay,Samandağ
65-69,1485,1650,3135,Hatay,Samandağ
70-74,951,1115,2066,Hatay,Samandağ
75+,1585,2121,3706,Hatay,Samandağ
18-24,2405,2608,5013,Aydın,İncirliova
25-29,1761,1824,3585,Aydın,İncirliova
30-34,1918,1843,3761,Aydın,İncirliova
35-39,1849,1827,3676,Aydın,İncirliova
40-44,1669,1699,3368,Aydın,İncirliova
45-49,1725,1540,3265,Aydın,İncirliova
50-54,1530,1452,2982,Aydın,İncirliova
55-59,1453,1486,2939,Aydın,İncirliova
60-64,1168,1262,2430,Aydın,İncirliova
65-69,874,937,1811,Aydın,İncirliova
70-74,540,709,1249,Aydın,İncirliova
75+,833,1287,2120,Aydın,İncirliova
18-24,2530,2687,5217,Erzurum,Horasan
25-29,1485,1409,2894,Erzurum,Horasan
30-34,1309,1217,2526,Erzurum,Horasan
35-39,1318,1241,2559,Erzurum,Horasan
40-44,992,945,1937,Erzurum,Horasan
45-49,928,869,1797,Erzurum,Horasan
50-54,882,720,1602,Erzurum,Horasan
55-59,669,691,1360,Erzurum,Horasan
60-64,544,558,1102,Erzurum,Horasan
65-69,464,540,1004,Erzurum,Horasan
70-74,334,413,747,Erzurum,Horasan
75+,435,623,1058,Erzurum,Horasan
18-24,2414,2650,5064,Elazığ,Kovancılar
25-29,1595,1609,3204,Elazığ,Kovancılar
30-34,1672,1511,3183,Elazığ,Kovancılar
35-39,1419,1494,2913,Elazığ,Kovancılar
40-44,1147,1233,2380,Elazığ,Kovancılar
45-49,1005,1048,2053,Elazığ,Kovancılar
50-54,897,875,1772,Elazığ,Kovancılar
55-59,683,771,1454,Elazığ,Kovancılar
60-64,621,692,1313,Elazığ,Kovancılar
65-69,431,531,962,Elazığ,Kovancılar
70-74,298,390,688,Elazığ,Kovancılar
75+,507,647,1154,Elazığ,Kovancılar
18-24,17289,18570,35859,Adıyaman,Adıyaman Merkez
25-29,11631,11705,23336,Adıyaman,Adıyaman Merkez
30-34,11817,11846,23663,Adıyaman,Adıyaman Merkez
35-39,12011,11830,23841,Adıyaman,Adıyaman Merkez
40-44,9814,9620,19434,Adıyaman,Adıyaman Merkez
45-49,8558,8288,16846,Adıyaman,Adıyaman Merkez
50-54,7447,6449,13896,Adıyaman,Adıyaman Merkez
55-59,5213,5484,10697,Adıyaman,Adıyaman Merkez
60-64,4216,3987,8203,Adıyaman,Adıyaman Merkez
65-69,3216,3712,6928,Adıyaman,Adıyaman Merkez
70-74,1892,2623,4515,Adıyaman,Adıyaman Merkez
75+,2812,3688,6500,Adıyaman,Adıyaman Merkez
18-24,18975,20231,39206,Ankara,Altındağ
25-29,14423,14439,28862,Ankara,Altındağ
30-34,14810,14581,29391,Ankara,Altındağ
35-39,15212,14582,29794,Ankara,Altındağ
40-44,13686,12951,26637,Ankara,Altındağ
45-49,12516,11922,24438,Ankara,Altındağ
50-54,10913,10606,21519,Ankara,Altındağ
55-59,9180,8906,18086,Ankara,Altındağ
60-64,6766,6815,13581,Ankara,Altındağ
65-69,4518,5296,9814,Ankara,Altındağ
70-74,2728,3638,6366,Ankara,Altındağ
75+,3773,6222,9995,Ankara,Altındağ
18-24,10590,11848,22438,Mardin,Artuklu
25-29,7836,7884,15720,Mardin,Artuklu
30-34,6785,6504,13289,Mardin,Artuklu
35-39,5703,5743,11446,Mardin,Artuklu
40-44,4548,4392,8940,Mardin,Artuklu
45-49,3918,3792,7710,Mardin,Artuklu
50-54,3144,2759,5903,Mardin,Artuklu
55-59,2205,2176,4381,Mardin,Artuklu
60-64,1746,1640,3386,Mardin,Artuklu
65-69,1193,1309,2502,Mardin,Artuklu
70-74,737,974,1711,Mardin,Artuklu
75+,1287,1740,3027,Mardin,Artuklu
18-24,362,376,738,Aksaray,Ağaçören
25-29,207,180,387,Aksaray,Ağaçören
30-34,202,191,393,Aksaray,Ağaçören
35-39,267,213,480,Aksaray,Ağaçören
40-44,253,226,479,Aksaray,Ağaçören
45-49,221,243,464,Aksaray,Ağaçören
50-54,250,291,541,Aksaray,Ağaçören
55-59,267,306,573,Aksaray,Ağaçören
60-64,292,343,635,Aksaray,Ağaçören
65-69,258,341,599,Aksaray,Ağaçören
70-74,193,212,405,Aksaray,Ağaçören
75+,251,339,590,Aksaray,Ağaçören
18-24,378,318,696,Giresun,Doğankent
25-29,233,192,425,Giresun,Doğankent
30-34,229,200,429,Giresun,Doğankent
35-39,215,184,399,Giresun,Doğankent
40-44,195,167,362,Giresun,Doğankent
45-49,208,178,386,Giresun,Doğankent
50-54,239,182,421,Giresun,Doğankent
55-59,179,205,384,Giresun,Doğankent
60-64,212,196,408,Giresun,Doğankent
65-69,148,178,326,Giresun,Doğankent
70-74,83,145,228,Giresun,Doğankent
75+,147,275,422,Giresun,Doğankent
18-24,258,262,520,Kastamonu,Küre
25-29,191,156,347,Kastamonu,Küre
30-34,229,164,393,Kastamonu,Küre
35-39,199,175,374,Kastamonu,Küre
40-44,178,161,339,Kastamonu,Küre
45-49,161,151,312,Kastamonu,Küre
50-54,183,179,362,Kastamonu,Küre
55-59,184,202,386,Kastamonu,Küre
60-64,177,192,369,Kastamonu,Küre
65-69,164,204,368,Kastamonu,Küre
70-74,114,165,279,Kastamonu,Küre
75+,199,246,445,Kastamonu,Küre
18-24,1253,1253,2506,Yalova,Çınarcık
25-29,939,852,1791,Yalova,Çınarcık
30-34,907,762,1669,Yalova,Çınarcık
35-39,904,895,1799,Yalova,Çınarcık
40-44,891,949,1840,Yalova,Çınarcık
45-49,884,999,1883,Yalova,Çınarcık
50-54,983,1150,2133,Yalova,Çınarcık
55-59,1119,1222,2341,Yalova,Çınarcık
60-64,1140,1217,2357,Yalova,Çınarcık
65-69,996,1020,2016,Yalova,Çınarcık
70-74,738,737,1475,Yalova,Çınarcık
75+,949,1120,2069,Yalova,Çınarcık
18-24,3070,3073,6143,Tekirdağ,Ergene
25-29,2607,2237,4844,Tekirdağ,Ergene
30-34,2677,2411,5088,Tekirdağ,Ergene
35-39,2863,2361,5224,Tekirdağ,Ergene
40-44,2410,2146,4556,Tekirdağ,Ergene
45-49,2177,1937,4114,Tekirdağ,Ergene
50-54,1994,1915,3909,Tekirdağ,Ergene
55-59,1783,1641,3424,Tekirdağ,Ergene
60-64,1407,1423,2830,Tekirdağ,Ergene
65-69,976,1117,2093,Tekirdağ,Ergene
70-74,608,770,1378,Tekirdağ,Ergene
75+,784,1143,1927,Tekirdağ,Ergene
18-24,1384,1375,2759,Trabzon,Vakfıkebir
25-29,838,854,1692,Trabzon,Vakfıkebir
30-34,788,802,1590,Trabzon,Vakfıkebir
35-39,889,895,1784,Trabzon,Vakfıkebir
40-44,851,909,1760,Trabzon,Vakfıkebir
45-49,902,920,1822,Trabzon,Vakfıkebir
50-54,965,882,1847,Trabzon,Vakfıkebir
55-59,882,886,1768,Trabzon,Vakfıkebir
60-64,807,911,1718,Trabzon,Vakfıkebir
65-69,558,607,1165,Trabzon,Vakfıkebir
70-74,386,544,930,Trabzon,Vakfıkebir
75+,762,1260,2022,Trabzon,Vakfıkebir
18-24,1833,1840,3673,İzmir,Çeşme
25-29,1487,1407,2894,İzmir,Çeşme
30-34,1591,1522,3113,İzmir,Çeşme
35-39,1842,1732,3574,İzmir,Çeşme
40-44,1660,1546,3206,İzmir,Çeşme
45-49,1570,1539,3109,İzmir,Çeşme
50-54,1509,1480,2989,İzmir,Çeşme
55-59,1461,1417,2878,İzmir,Çeşme
60-64,1268,1330,2598,İzmir,Çeşme
65-69,1067,1029,2096,İzmir,Çeşme
70-74,802,874,1676,İzmir,Çeşme
75+,1077,1134,2211,İzmir,Çeşme
18-24,445,417,862,Rize,İyidere
25-29,235,235,470,Rize,İyidere
30-34,233,221,454,Rize,İyidere
35-39,291,254,545,Rize,İyidere
40-44,285,286,571,Rize,İyidere
45-49,378,318,696,Rize,İyidere
50-54,332,332,664,Rize,İyidere
55-59,288,297,585,Rize,İyidere
60-64,279,278,557,Rize,İyidere
65-69,199,219,418,Rize,İyidere
70-74,124,210,334,Rize,İyidere
75+,193,349,542,Rize,İyidere
18-24,283,259,542,Burdur,Altınyayla
25-29,152,140,292,Burdur,Altınyayla
30-34,161,130,291,Burdur,Altınyayla
35-39,154,140,294,Burdur,Altınyayla
40-44,155,151,306,Burdur,Altınyayla
45-49,187,198,385,Burdur,Altınyayla
50-54,211,186,397,Burdur,Altınyayla
55-59,182,209,391,Burdur,Altınyayla
60-64,173,183,356,Burdur,Altınyayla
65-69,137,135,272,Burdur,Altınyayla
70-74,101,142,243,Burdur,Altınyayla
75+,229,319,548,Burdur,Altınyayla
18-24,588,574,1162,Bolu,Göynük
25-29,509,403,912,Bolu,Göynük
30-34,510,444,954,Bolu,Göynük
35-39,526,484,1010,Bolu,Göynük
40-44,518,435,953,Bolu,Göynük
45-49,396,442,838,Bolu,Göynük
50-54,431,473,904,Bolu,Göynük
55-59,477,515,992,Bolu,Göynük
60-64,515,526,1041,Bolu,Göynük
65-69,413,478,891,Bolu,Göynük
70-74,362,430,792,Bolu,Göynük
75+,719,891,1610,Bolu,Göynük
18-24,28369,29023,57392,Antalya,Kepez
25-29,21073,21534,42607,Antalya,Kepez
30-34,22364,21781,44145,Antalya,Kepez
35-39,23556,22395,45951,Antalya,Kepez
40-44,19883,19356,39239,Antalya,Kepez
45-49,17437,17120,34557,Antalya,Kepez
50-54,15163,14248,29411,Antalya,Kepez
55-59,12318,11870,24188,Antalya,Kepez
60-64,8895,8959,17854,Antalya,Kepez
65-69,6013,5972,11985,Antalya,Kepez
70-74,3361,3699,7060,Antalya,Kepez
75+,3482,4628,8110,Antalya,Kepez
18-24,283,276,559,Kırşehir,Boztepe
25-29,190,144,334,Kırşehir,Boztepe
30-34,123,105,228,Kırşehir,Boztepe
35-39,158,138,296,Kırşehir,Boztepe
40-44,152,154,306,Kırşehir,Boztepe
45-49,185,195,380,Kırşehir,Boztepe
50-54,245,211,456,Kırşehir,Boztepe
55-59,239,202,441,Kırşehir,Boztepe
60-64,196,202,398,Kırşehir,Boztepe
65-69,150,164,314,Kırşehir,Boztepe
70-74,117,181,298,Kırşehir,Boztepe
75+,133,224,357,Kırşehir,Boztepe
18-24,179,181,360,Kırıkkale,Karakeçili
25-29,107,85,192,Kırıkkale,Karakeçili
30-34,72,85,157,Kırıkkale,Karakeçili
35-39,89,84,173,Kırıkkale,Karakeçili
40-44,97,87,184,Kırıkkale,Karakeçili
45-49,108,103,211,Kırıkkale,Karakeçili
50-54,125,117,242,Kırıkkale,Karakeçili
55-59,102,98,200,Kırıkkale,Karakeçili
60-64,94,102,196,Kırıkkale,Karakeçili
65-69,63,97,160,Kırıkkale,Karakeçili
70-74,68,51,119,Kırıkkale,Karakeçili
75+,70,112,182,Kırıkkale,Karakeçili
18-24,225,279,504,Bursa,Harmancık
25-29,157,160,317,Bursa,Harmancık
30-34,201,167,368,Bursa,Harmancık
35-39,179,153,332,Bursa,Harmancık
40-44,153,145,298,Bursa,Harmancık
45-49,175,183,358,Bursa,Harmancık
50-54,217,266,483,Bursa,Harmancık
55-59,272,322,594,Bursa,Harmancık
60-64,273,311,584,Bursa,Harmancık
65-69,227,274,501,Bursa,Harmancık
70-74,163,202,365,Bursa,Harmancık
75+,280,366,646,Bursa,Harmancık
18-24,36552,36864,73416,İstanbul,Pendik
25-29,29121,29565,58686,İstanbul,Pendik
30-34,32140,31879,64019,İstanbul,Pendik
35-39,34691,33362,68053,İstanbul,Pendik
40-44,29241,27373,56614,İstanbul,Pendik
45-49,24214,22504,46718,İstanbul,Pendik
50-54,19564,18422,37986,İstanbul,Pendik
55-59,15074,14319,29393,İstanbul,Pendik
60-64,10679,10974,21653,İstanbul,Pendik
65-69,6907,7397,14304,İstanbul,Pendik
70-74,3922,5021,8943,İstanbul,Pendik
75+,4622,7304,11926,İstanbul,Pendik
18-24,348,316,664,Çanakkale,Eceabat
25-29,260,240,500,Çanakkale,Eceabat
30-34,293,249,542,Çanakkale,Eceabat
35-39,338,308,646,Çanakkale,Eceabat
40-44,273,268,541,Çanakkale,Eceabat
45-49,341,300,641,Çanakkale,Eceabat
50-54,320,307,627,Çanakkale,Eceabat
55-59,371,360,731,Çanakkale,Eceabat
60-64,350,354,704,Çanakkale,Eceabat
65-69,285,313,598,Çanakkale,Eceabat
70-74,218,210,428,Çanakkale,Eceabat
75+,308,479,787,Çanakkale,Eceabat
18-24,102,102,204,Antalya,İbradı
25-29,96,62,158,Antalya,İbradı
30-34,87,59,146,Antalya,İbradı
35-39,83,68,151,Antalya,İbradı
40-44,79,75,154,Antalya,İbradı
45-49,78,83,161,Antalya,İbradı
50-54,83,83,166,Antalya,İbradı
55-59,114,101,215,Antalya,İbradı
60-64,90,98,188,Antalya,İbradı
65-69,66,90,156,Antalya,İbradı
70-74,82,97,179,Antalya,İbradı
75+,173,239,412,Antalya,İbradı
18-24,15004,15249,30253,İstanbul,Kadıköy
25-29,13875,14784,28659,İstanbul,Kadıköy
30-34,15863,17340,33203,İstanbul,Kadıköy
35-39,17512,19716,37228,İstanbul,Kadıköy
40-44,15963,18500,34463,İstanbul,Kadıköy
45-49,14433,17380,31813,İstanbul,Kadıköy
50-54,12875,16524,29399,İstanbul,Kadıköy
55-59,12602,16503,29105,İstanbul,Kadıköy
60-64,11960,15898,27858,İstanbul,Kadıköy
65-69,10288,13841,24129,İstanbul,Kadıköy
70-74,8429,12107,20536,İstanbul,Kadıköy
75+,13211,23556,36767,İstanbul,Kadıköy
18-24,7776,8232,16008,Ankara,Pursaklar
25-29,5441,6019,11460,Ankara,Pursaklar
30-34,5972,6360,12332,Ankara,Pursaklar
35-39,6427,6368,12795,Ankara,Pursaklar
40-44,5746,5330,11076,Ankara,Pursaklar
45-49,4762,4585,9347,Ankara,Pursaklar
50-54,4034,3744,7778,Ankara,Pursaklar
55-59,3200,3014,6214,Ankara,Pursaklar
60-64,2139,2063,4202,Ankara,Pursaklar
65-69,1322,1398,2720,Ankara,Pursaklar
70-74,719,897,1616,Ankara,Pursaklar
75+,858,1259,2117,Ankara,Pursaklar
18-24,12289,13227,25516,Diyarbakır,Yenişehir
25-29,9578,9495,19073,Diyarbakır,Yenişehir
30-34,8270,8080,16350,Diyarbakır,Yenişehir
35-39,7770,7812,15582,Diyarbakır,Yenişehir
40-44,6020,6171,12191,Diyarbakır,Yenişehir
45-49,4814,4766,9580,Diyarbakır,Yenişehir
50-54,4119,3880,7999,Diyarbakır,Yenişehir
55-59,2797,2872,5669,Diyarbakır,Yenişehir
60-64,2007,2073,4080,Diyarbakır,Yenişehir
65-69,1407,1685,3092,Diyarbakır,Yenişehir
70-74,905,1345,2250,Diyarbakır,Yenişehir
75+,1375,2215,3590,Diyarbakır,Yenişehir
18-24,1624,1548,3172,Manisa,Sarıgöl
25-29,1012,1037,2049,Manisa,Sarıgöl
30-34,1178,1184,2362,Manisa,Sarıgöl
35-39,1356,1316,2672,Manisa,Sarıgöl
40-44,1315,1253,2568,Manisa,Sarıgöl
45-49,1303,1282,2585,Manisa,Sarıgöl
50-54,1425,1330,2755,Manisa,Sarıgöl
55-59,1343,1422,2765,Manisa,Sarıgöl
60-64,1167,1196,2363,Manisa,Sarıgöl
65-69,857,966,1823,Manisa,Sarıgöl
70-74,520,712,1232,Manisa,Sarıgöl
75+,786,1262,2048,Manisa,Sarıgöl
18-24,1499,1539,3038,Siirt,Şirvan
25-29,839,697,1536,Siirt,Şirvan
30-34,524,525,1049,Siirt,Şirvan
35-39,575,601,1176,Siirt,Şirvan
40-44,477,452,929,Siirt,Şirvan
45-49,393,350,743,Siirt,Şirvan
50-54,367,369,736,Siirt,Şirvan
55-59,315,259,574,Siirt,Şirvan
60-64,228,274,502,Siirt,Şirvan
65-69,188,261,449,Siirt,Şirvan
70-74,157,182,339,Siirt,Şirvan
75+,196,301,497,Siirt,Şirvan
18-24,1302,1309,2611,Yalova,Altınova
25-29,971,956,1927,Yalova,Altınova
30-34,977,903,1880,Yalova,Altınova
35-39,1131,1053,2184,Yalova,Altınova
40-44,988,879,1867,Yalova,Altınova
45-49,884,783,1667,Yalova,Altınova
50-54,741,729,1470,Yalova,Altınova
55-59,673,658,1331,Yalova,Altınova
60-64,615,640,1255,Yalova,Altınova
65-69,452,472,924,Yalova,Altınova
70-74,309,354,663,Yalova,Altınova
75+,396,592,988,Yalova,Altınova
18-24,2380,2652,5032,Hatay,Erzin
25-29,1479,1447,2926,Hatay,Erzin
30-34,1504,1439,2943,Hatay,Erzin
35-39,1499,1500,2999,Hatay,Erzin
40-44,1233,1315,2548,Hatay,Erzin
45-49,1156,1277,2433,Hatay,Erzin
50-54,1159,1106,2265,Hatay,Erzin
55-59,1124,1078,2202,Hatay,Erzin
60-64,909,888,1797,Hatay,Erzin
65-69,690,702,1392,Hatay,Erzin
70-74,396,445,841,Hatay,Erzin
75+,494,733,1227,Hatay,Erzin
18-24,23590,24259,47849,İzmir,Karabağlar
25-29,18193,18009,36202,İzmir,Karabağlar
30-34,18816,18979,37795,İzmir,Karabağlar
35-39,20058,20363,40421,İzmir,Karabağlar
40-44,18470,18771,37241,İzmir,Karabağlar
45-49,16532,17294,33826,İzmir,Karabağlar
50-54,14740,15414,30154,İzmir,Karabağlar
55-59,13473,13943,27416,İzmir,Karabağlar
60-64,10957,11910,22867,İzmir,Karabağlar
65-69,7982,9673,17655,İzmir,Karabağlar
70-74,5660,6848,12508,İzmir,Karabağlar
75+,6690,10500,17190,İzmir,Karabağlar
18-24,1415,1453,2868,Erzurum,Aşkale
25-29,799,799,1598,Erzurum,Aşkale
30-34,853,783,1636,Erzurum,Aşkale
35-39,864,823,1687,Erzurum,Aşkale
40-44,797,699,1496,Erzurum,Aşkale
45-49,697,661,1358,Erzurum,Aşkale
50-54,580,583,1163,Erzurum,Aşkale
55-59,444,479,923,Erzurum,Aşkale
60-64,412,482,894,Erzurum,Aşkale
65-69,377,452,829,Erzurum,Aşkale
70-74,306,358,664,Erzurum,Aşkale
75+,419,517,936,Erzurum,Aşkale
18-24,491,412,903,Isparta,Uluborlu
25-29,190,185,375,Isparta,Uluborlu
30-34,186,168,354,Isparta,Uluborlu
35-39,192,170,362,Isparta,Uluborlu
40-44,185,165,350,Isparta,Uluborlu
45-49,148,178,326,Isparta,Uluborlu
50-54,179,185,364,Isparta,Uluborlu
55-59,199,194,393,Isparta,Uluborlu
60-64,185,202,387,Isparta,Uluborlu
65-69,184,198,382,Isparta,Uluborlu
70-74,108,157,265,Isparta,Uluborlu
75+,242,361,603,Isparta,Uluborlu
18-24,16967,17447,34414,Mardin,Kızıltepe
25-29,10726,10749,21475,Mardin,Kızıltepe
30-34,9269,8817,18086,Mardin,Kızıltepe
35-39,8354,8090,16444,Mardin,Kızıltepe
40-44,6212,6289,12501,Mardin,Kızıltepe
45-49,5153,5071,10224,Mardin,Kızıltepe
50-54,4247,4044,8291,Mardin,Kızıltepe
55-59,2823,2947,5770,Mardin,Kızıltepe
60-64,1994,2352,4346,Mardin,Kızıltepe
65-69,1448,1916,3364,Mardin,Kızıltepe
70-74,1047,1377,2424,Mardin,Kızıltepe
75+,1543,2346,3889,Mardin,Kızıltepe
18-24,1384,1423,2807,Artvin,Hopa
25-29,940,909,1849,Artvin,Hopa
30-34,973,941,1914,Artvin,Hopa
35-39,1006,970,1976,Artvin,Hopa
40-44,1008,918,1926,Artvin,Hopa
45-49,1046,983,2029,Artvin,Hopa
50-54,934,836,1770,Artvin,Hopa
55-59,759,691,1450,Artvin,Hopa
60-64,602,671,1273,Artvin,Hopa
65-69,444,459,903,Artvin,Hopa
70-74,280,392,672,Artvin,Hopa
75+,404,768,1172,Artvin,Hopa
18-24,644,548,1192,Ordu,Gürgentepe
25-29,346,282,628,Ordu,Gürgentepe
30-34,340,287,627,Ordu,Gürgentepe
35-39,411,366,777,Ordu,Gürgentepe
40-44,438,391,829,Ordu,Gürgentepe
45-49,504,480,984,Ordu,Gürgentepe
50-54,659,626,1285,Ordu,Gürgentepe
55-59,633,600,1233,Ordu,Gürgentepe
60-64,529,589,1118,Ordu,Gürgentepe
65-69,415,490,905,Ordu,Gürgentepe
70-74,271,327,598,Ordu,Gürgentepe
75+,323,559,882,Ordu,Gürgentepe
18-24,305,288,593,Kırıkkale,Balışeyh
25-29,188,117,305,Kırıkkale,Balışeyh
30-34,170,144,314,Kırıkkale,Balışeyh
35-39,172,141,313,Kırıkkale,Balışeyh
40-44,152,142,294,Kırıkkale,Balışeyh
45-49,189,178,367,Kırıkkale,Balışeyh
50-54,237,179,416,Kırıkkale,Balışeyh
55-59,232,185,417,Kırıkkale,Balışeyh
60-64,184,201,385,Kırıkkale,Balışeyh
65-69,172,190,362,Kırıkkale,Balışeyh
70-74,115,136,251,Kırıkkale,Balışeyh
75+,148,277,425,Kırıkkale,Balışeyh
18-24,2710,2613,5323,İzmir,Narlıdere
25-29,2039,2085,4124,İzmir,Narlıdere
30-34,2238,2280,4518,İzmir,Narlıdere
35-39,2401,2632,5033,İzmir,Narlıdere
40-44,2401,2720,5121,İzmir,Narlıdere
45-49,2223,2610,4833,İzmir,Narlıdere
50-54,2182,2331,4513,İzmir,Narlıdere
55-59,2039,2147,4186,İzmir,Narlıdere
60-64,1620,1793,3413,İzmir,Narlıdere
65-69,1365,1558,2923,İzmir,Narlıdere
70-74,1028,1153,2181,İzmir,Narlıdere
75+,1356,1881,3237,İzmir,Narlıdere
18-24,2014,2199,4213,Samsun,Havza
25-29,1023,1037,2060,Samsun,Havza
30-34,1125,1140,2265,Samsun,Havza
35-39,1207,1272,2479,Samsun,Havza
40-44,1125,1241,2366,Samsun,Havza
45-49,1157,1210,2367,Samsun,Havza
50-54,1294,1409,2703,Samsun,Havza
55-59,1328,1298,2626,Samsun,Havza
60-64,1336,1271,2607,Samsun,Havza
65-69,1039,1142,2181,Samsun,Havza
70-74,750,931,1681,Samsun,Havza
75+,1202,1469,2671,Samsun,Havza
18-24,35028,35693,70721,İstanbul,Ümraniye
25-29,27417,29122,56539,İstanbul,Ümraniye
30-34,31186,32228,63414,İstanbul,Ümraniye
35-39,33941,33993,67934,İstanbul,Ümraniye
40-44,29829,28702,58531,İstanbul,Ümraniye
45-49,24912,23732,48644,İstanbul,Ümraniye
50-54,20033,18889,38922,İstanbul,Ümraniye
55-59,15690,14990,30680,İstanbul,Ümraniye
60-64,10740,11196,21936,İstanbul,Ümraniye
65-69,6968,7355,14323,İstanbul,Ümraniye
70-74,3922,4769,8691,İstanbul,Ümraniye
75+,4070,6856,10926,İstanbul,Ümraniye
18-24,841,867,1708,Çorum,Bayat
25-29,438,461,899,Çorum,Bayat
30-34,437,428,865,Çorum,Bayat
35-39,436,443,879,Çorum,Bayat
40-44,369,402,771,Çorum,Bayat
45-49,468,515,983,Çorum,Bayat
50-54,485,518,1003,Çorum,Bayat
55-59,509,607,1116,Çorum,Bayat
60-64,586,652,1238,Çorum,Bayat
65-69,430,619,1049,Çorum,Bayat
70-74,369,506,875,Çorum,Bayat
75+,727,793,1520,Çorum,Bayat
18-24,7871,8829,16700,Van,Edremit
25-29,6007,6520,12527,Van,Edremit
30-34,5589,5307,10896,Van,Edremit
35-39,4950,5037,9987,Van,Edremit
40-44,3353,3082,6435,Van,Edremit
45-49,2714,2294,5008,Van,Edremit
50-54,2253,2091,4344,Van,Edremit
55-59,1602,1540,3142,Van,Edremit
60-64,1139,1278,2417,Van,Edremit
65-69,775,911,1686,Van,Edremit
70-74,469,613,1082,Van,Edremit
75+,594,879,1473,Van,Edremit
18-24,2770,2755,5525,Kocaeli,Karamürsel
25-29,1925,1854,3779,Kocaeli,Karamürsel
30-34,2038,1893,3931,Kocaeli,Karamürsel
35-39,2182,2228,4410,Kocaeli,Karamürsel
40-44,2108,2064,4172,Kocaeli,Karamürsel
45-49,1871,2006,3877,Kocaeli,Karamürsel
50-54,1735,1806,3541,Kocaeli,Karamürsel
55-59,1662,1862,3524,Kocaeli,Karamürsel
60-64,1562,1609,3171,Kocaeli,Karamürsel
65-69,1183,1206,2389,Kocaeli,Karamürsel
70-74,815,956,1771,Kocaeli,Karamürsel
75+,1128,1527,2655,Kocaeli,Karamürsel
18-24,64,67,131,Bilecik,İnhisar
25-29,57,37,94,Bilecik,İnhisar
30-34,26,31,57,Bilecik,İnhisar
35-39,46,36,82,Bilecik,İnhisar
40-44,49,45,94,Bilecik,İnhisar
45-49,66,70,136,Bilecik,İnhisar
50-54,85,88,173,Bilecik,İnhisar
55-59,103,108,211,Bilecik,İnhisar
60-64,114,114,228,Bilecik,İnhisar
65-69,92,106,198,Bilecik,İnhisar
70-74,85,110,195,Bilecik,İnhisar
75+,177,236,413,Bilecik,İnhisar
18-24,134,111,245,Kütahya,Dumlupınar
25-29,72,71,143,Kütahya,Dumlupınar
30-34,82,60,142,Kütahya,Dumlupınar
35-39,87,72,159,Kütahya,Dumlupınar
40-44,85,75,160,Kütahya,Dumlupınar
45-49,88,86,174,Kütahya,Dumlupınar
50-54,98,98,196,Kütahya,Dumlupınar
55-59,129,110,239,Kütahya,Dumlupınar
60-64,107,125,232,Kütahya,Dumlupınar
65-69,86,104,190,Kütahya,Dumlupınar
70-74,93,92,185,Kütahya,Dumlupınar
75+,155,199,354,Kütahya,Dumlupınar
18-24,507,561,1068,Burdur,Yeşilova
25-29,348,313,661,Burdur,Yeşilova
30-34,381,314,695,Burdur,Yeşilova
35-39,475,411,886,Burdur,Yeşilova
40-44,474,436,910,Burdur,Yeşilova
45-49,485,473,958,Burdur,Yeşilova
50-54,521,537,1058,Burdur,Yeşilova
55-59,624,659,1283,Burdur,Yeşilova
60-64,683,699,1382,Burdur,Yeşilova
65-69,518,692,1210,Burdur,Yeşilova
70-74,442,594,1036,Burdur,Yeşilova
75+,797,1228,2025,Burdur,Yeşilova
18-24,270,246,516,Denizli,Bekilli
25-29,151,158,309,Denizli,Bekilli
30-34,184,144,328,Denizli,Bekilli
35-39,197,172,369,Denizli,Bekilli
40-44,211,209,420,Denizli,Bekilli
45-49,214,214,428,Denizli,Bekilli
50-54,238,248,486,Denizli,Bekilli
55-59,273,280,553,Denizli,Bekilli
60-64,218,273,491,Denizli,Bekilli
65-69,237,309,546,Denizli,Bekilli
70-74,167,239,406,Denizli,Bekilli
75+,325,545,870,Denizli,Bekilli
18-24,4683,4473,9156,Kahramanmaraş,Afşin
25-29,2462,2651,5113,Kahramanmaraş,Afşin
30-34,2908,2640,5548,Kahramanmaraş,Afşin
35-39,3006,2826,5832,Kahramanmaraş,Afşin
40-44,2718,2373,5091,Kahramanmaraş,Afşin
45-49,2572,2428,5000,Kahramanmaraş,Afşin
50-54,2092,1976,4068,Kahramanmaraş,Afşin
55-59,1912,1771,3683,Kahramanmaraş,Afşin
60-64,1441,1479,2920,Kahramanmaraş,Afşin
65-69,1244,1280,2524,Kahramanmaraş,Afşin
70-74,978,1090,2068,Kahramanmaraş,Afşin
75+,1366,1864,3230,Kahramanmaraş,Afşin
18-24,89,60,149,Kırklareli,Kofçaz
25-29,48,47,95,Kırklareli,Kofçaz
30-34,55,34,89,Kırklareli,Kofçaz
35-39,75,38,113,Kırklareli,Kofçaz
40-44,66,46,112,Kırklareli,Kofçaz
45-49,73,59,132,Kırklareli,Kofçaz
50-54,110,86,196,Kırklareli,Kofçaz
55-59,113,105,218,Kırklareli,Kofçaz
60-64,129,110,239,Kırklareli,Kofçaz
65-69,92,104,196,Kırklareli,Kofçaz
70-74,80,106,186,Kırklareli,Kofçaz
75+,144,181,325,Kırklareli,Kofçaz
18-24,4463,4758,9221,Kocaeli,Başiskele
25-29,3557,3868,7425,Kocaeli,Başiskele
30-34,4110,4173,8283,Kocaeli,Başiskele
35-39,4477,4426,8903,Kocaeli,Başiskele
40-44,3845,3603,7448,Kocaeli,Başiskele
45-49,3082,3025,6107,Kocaeli,Başiskele
50-54,2701,2572,5273,Kocaeli,Başiskele
55-59,2229,2077,4306,Kocaeli,Başiskele
60-64,1742,1762,3504,Kocaeli,Başiskele
65-69,1231,1211,2442,Kocaeli,Başiskele
70-74,799,814,1613,Kocaeli,Başiskele
75+,824,1150,1974,Kocaeli,Başiskele
18-24,8822,8982,17804,Mersin,Mezitli
25-29,5772,6643,12415,Mersin,Mezitli
30-34,6660,7415,14075,Mersin,Mezitli
35-39,7036,8336,15372,Mersin,Mezitli
40-44,6836,7575,14411,Mersin,Mezitli
45-49,6034,6701,12735,Mersin,Mezitli
50-54,5700,6302,12002,Mersin,Mezitli
55-59,5158,5837,10995,Mersin,Mezitli
60-64,4559,4771,9330,Mersin,Mezitli
65-69,3388,3424,6812,Mersin,Mezitli
70-74,2019,2032,4051,Mersin,Mezitli
75+,1844,2366,4210,Mersin,Mezitli
18-24,24023,26037,50060,Diyarbakır,Bağlar
25-29,18420,18847,37267,Diyarbakır,Bağlar
30-34,16505,15662,32167,Diyarbakır,Bağlar
35-39,15199,14396,29595,Diyarbakır,Bağlar
40-44,10977,10927,21904,Diyarbakır,Bağlar
45-49,8634,8287,16921,Diyarbakır,Bağlar
50-54,6844,6609,13453,Diyarbakır,Bağlar
55-59,4817,4898,9715,Diyarbakır,Bağlar
60-64,3400,3585,6985,Diyarbakır,Bağlar
65-69,2456,3084,5540,Diyarbakır,Bağlar
70-74,1673,2103,3776,Diyarbakır,Bağlar
75+,2066,3250,5316,Diyarbakır,Bağlar
18-24,1131,1144,2275,Tekirdağ,Marmaraereğlisi
25-29,854,761,1615,Tekirdağ,Marmaraereğlisi
30-34,879,783,1662,Tekirdağ,Marmaraereğlisi
35-39,921,822,1743,Tekirdağ,Marmaraereğlisi
40-44,819,749,1568,Tekirdağ,Marmaraereğlisi
45-49,828,755,1583,Tekirdağ,Marmaraereğlisi
50-54,804,749,1553,Tekirdağ,Marmaraereğlisi
55-59,873,819,1692,Tekirdağ,Marmaraereğlisi
60-64,841,847,1688,Tekirdağ,Marmaraereğlisi
65-69,685,643,1328,Tekirdağ,Marmaraereğlisi
70-74,479,481,960,Tekirdağ,Marmaraereğlisi
75+,600,588,1188,Tekirdağ,Marmaraereğlisi
18-24,24962,25074,50036,İzmir,Buca
25-29,19470,19534,39004,İzmir,Buca
30-34,19815,19906,39721,İzmir,Buca
35-39,20751,21173,41924,İzmir,Buca
40-44,19005,19066,38071,İzmir,Buca
45-49,16392,16964,33356,İzmir,Buca
50-54,15093,15565,30658,İzmir,Buca
55-59,13528,13556,27084,İzmir,Buca
60-64,10953,11016,21969,İzmir,Buca
65-69,7412,7993,15405,İzmir,Buca
70-74,4538,5172,9710,İzmir,Buca
75+,4985,7843,12828,İzmir,Buca
18-24,12983,13373,26356,Sakarya,Adapazarı
25-29,9298,9649,18947,Sakarya,Adapazarı
30-34,9813,10232,20045,Sakarya,Adapazarı
35-39,11308,11634,22942,Sakarya,Adapazarı
40-44,10382,10194,20576,Sakarya,Adapazarı
45-49,9183,9091,18274,Sakarya,Adapazarı
50-54,7764,7933,15697,Sakarya,Adapazarı
55-59,7027,7363,14390,Sakarya,Adapazarı
60-64,5963,6081,12044,Sakarya,Adapazarı
65-69,4266,4664,8930,Sakarya,Adapazarı
70-74,2743,3307,6050,Sakarya,Adapazarı
75+,3333,5044,8377,Sakarya,Adapazarı
18-24,983,988,1971,Adıyaman,Çelikhan
25-29,572,565,1137,Adıyaman,Çelikhan
30-34,586,559,1145,Adıyaman,Çelikhan
35-39,613,520,1133,Adıyaman,Çelikhan
40-44,514,498,1012,Adıyaman,Çelikhan
45-49,491,414,905,Adıyaman,Çelikhan
50-54,403,372,775,Adıyaman,Çelikhan
55-59,274,301,575,Adıyaman,Çelikhan
60-64,259,258,517,Adıyaman,Çelikhan
65-69,272,278,550,Adıyaman,Çelikhan
70-74,192,200,392,Adıyaman,Çelikhan
75+,251,308,559,Adıyaman,Çelikhan
18-24,5807,6557,12364,Hatay,Kırıkhan
25-29,3956,3859,7815,Hatay,Kırıkhan
30-34,3960,3858,7818,Hatay,Kırıkhan
35-39,3982,3972,7954,Hatay,Kırıkhan
40-44,3436,3485,6921,Hatay,Kırıkhan
45-49,3320,3273,6593,Hatay,Kırıkhan
50-54,3127,3157,6284,Hatay,Kırıkhan
55-59,2695,2579,5274,Hatay,Kırıkhan
60-64,2121,2076,4197,Hatay,Kırıkhan
65-69,1504,1676,3180,Hatay,Kırıkhan
70-74,834,1125,1959,Hatay,Kırıkhan
75+,1379,1837,3216,Hatay,Kırıkhan
18-24,39272,38254,77526,Ankara,Çankaya
25-29,31823,31092,62915,Ankara,Çankaya
30-34,30871,32742,63613,Ankara,Çankaya
35-39,33029,37638,70667,Ankara,Çankaya
40-44,31350,36677,68027,Ankara,Çankaya
45-49,29627,35246,64873,Ankara,Çankaya
50-54,28520,32716,61236,Ankara,Çankaya
55-59,25480,29156,54636,Ankara,Çankaya
60-64,21832,24844,46676,Ankara,Çankaya
65-69,16557,19525,36082,Ankara,Çankaya
70-74,11845,14859,26704,Ankara,Çankaya
75+,16058,26769,42827,Ankara,Çankaya
18-24,864,781,1645,Adana,Saimbeyli
25-29,464,429,893,Adana,Saimbeyli
30-34,497,445,942,Adana,Saimbeyli
35-39,524,441,965,Adana,Saimbeyli
40-44,496,449,945,Adana,Saimbeyli
45-49,465,450,915,Adana,Saimbeyli
50-54,489,451,940,Adana,Saimbeyli
55-59,451,400,851,Adana,Saimbeyli
60-64,402,365,767,Adana,Saimbeyli
65-69,290,350,640,Adana,Saimbeyli
70-74,274,336,610,Adana,Saimbeyli
75+,414,415,829,Adana,Saimbeyli
18-24,301,269,570,Eskişehir,Mihalıççık
25-29,224,181,405,Eskişehir,Mihalıççık
30-34,236,210,446,Eskişehir,Mihalıççık
35-39,248,168,416,Eskişehir,Mihalıççık
40-44,237,211,448,Eskişehir,Mihalıççık
45-49,319,257,576,Eskişehir,Mihalıççık
50-54,348,328,676,Eskişehir,Mihalıççık
55-59,391,353,744,Eskişehir,Mihalıççık
60-64,347,312,659,Eskişehir,Mihalıççık
65-69,214,291,505,Eskişehir,Mihalıççık
70-74,227,303,530,Eskişehir,Mihalıççık
75+,391,634,1025,Eskişehir,Mihalıççık
18-24,90,78,168,Kırıkkale,Çelebi
25-29,60,41,101,Kırıkkale,Çelebi
30-34,57,58,115,Kırıkkale,Çelebi
35-39,66,38,104,Kırıkkale,Çelebi
40-44,60,53,113,Kırıkkale,Çelebi
45-49,73,57,130,Kırıkkale,Çelebi
50-54,72,65,137,Kırıkkale,Çelebi
55-59,107,95,202,Kırıkkale,Çelebi
60-64,77,79,156,Kırıkkale,Çelebi
65-69,90,89,179,Kırıkkale,Çelebi
70-74,53,89,142,Kırıkkale,Çelebi
75+,119,158,277,Kırıkkale,Çelebi
18-24,1141,984,2125,Elazığ,Arıcak
25-29,722,579,1301,Elazığ,Arıcak
30-34,521,463,984,Elazığ,Arıcak
35-39,484,433,917,Elazığ,Arıcak
40-44,385,395,780,Elazığ,Arıcak
45-49,311,301,612,Elazığ,Arıcak
50-54,283,285,568,Elazığ,Arıcak
55-59,299,261,560,Elazığ,Arıcak
60-64,243,253,496,Elazığ,Arıcak
65-69,167,245,412,Elazığ,Arıcak
70-74,153,183,336,Elazığ,Arıcak
75+,224,307,531,Elazığ,Arıcak
18-24,961,869,1830,Erzurum,Şenkaya
25-29,564,448,1012,Erzurum,Şenkaya
30-34,474,446,920,Erzurum,Şenkaya
35-39,529,519,1048,Erzurum,Şenkaya
40-44,584,511,1095,Erzurum,Şenkaya
45-49,585,523,1108,Erzurum,Şenkaya
50-54,543,564,1107,Erzurum,Şenkaya
55-59,436,605,1041,Erzurum,Şenkaya
60-64,408,460,868,Erzurum,Şenkaya
65-69,383,475,858,Erzurum,Şenkaya
70-74,408,536,944,Erzurum,Şenkaya
75+,802,879,1681,Erzurum,Şenkaya
18-24,541,558,1099,Rize,Kalkandere
25-29,402,318,720,Rize,Kalkandere
30-34,362,265,627,Rize,Kalkandere
35-39,330,305,635,Rize,Kalkandere
40-44,380,362,742,Rize,Kalkandere
45-49,465,431,896,Rize,Kalkandere
50-54,481,408,889,Rize,Kalkandere
55-59,400,408,808,Rize,Kalkandere
60-64,356,394,750,Rize,Kalkandere
65-69,294,328,622,Rize,Kalkandere
70-74,223,275,498,Rize,Kalkandere
75+,244,503,747,Rize,Kalkandere
18-24,1058,956,2014,Isparta,Şarkikaraağaç
25-29,658,667,1325,Isparta,Şarkikaraağaç
30-34,761,740,1501,Isparta,Şarkikaraağaç
35-39,894,774,1668,Isparta,Şarkikaraağaç
40-44,801,773,1574,Isparta,Şarkikaraağaç
45-49,853,876,1729,Isparta,Şarkikaraağaç
50-54,852,897,1749,Isparta,Şarkikaraağaç
55-59,984,1064,2048,Isparta,Şarkikaraağaç
60-64,859,912,1771,Isparta,Şarkikaraağaç
65-69,704,806,1510,Isparta,Şarkikaraağaç
70-74,451,638,1089,Isparta,Şarkikaraağaç
75+,708,1007,1715,Isparta,Şarkikaraağaç
18-24,2223,2471,4694,Afyonkarahisar,Sandıklı
25-29,1684,1757,3441,Afyonkarahisar,Sandıklı
30-34,1919,1863,3782,Afyonkarahisar,Sandıklı
35-39,2076,1904,3980,Afyonkarahisar,Sandıklı
40-44,1749,1743,3492,Afyonkarahisar,Sandıklı
45-49,1735,1826,3561,Afyonkarahisar,Sandıklı
50-54,1571,1798,3369,Afyonkarahisar,Sandıklı
55-59,1803,1938,3741,Afyonkarahisar,Sandıklı
60-64,1380,1602,2982,Afyonkarahisar,Sandıklı
65-69,1227,1414,2641,Afyonkarahisar,Sandıklı
70-74,869,1217,2086,Afyonkarahisar,Sandıklı
75+,1455,2031,3486,Afyonkarahisar,Sandıklı
18-24,1859,1825,3684,Siirt,Baykan
25-29,1039,894,1933,Siirt,Baykan
30-34,836,697,1533,Siirt,Baykan
35-39,660,726,1386,Siirt,Baykan
40-44,682,612,1294,Siirt,Baykan
45-49,495,441,936,Siirt,Baykan
50-54,451,393,844,Siirt,Baykan
55-59,361,312,673,Siirt,Baykan
60-64,306,346,652,Siirt,Baykan
65-69,223,308,531,Siirt,Baykan
70-74,147,213,360,Siirt,Baykan
75+,280,376,656,Siirt,Baykan
18-24,421,453,874,Çankırı,Şabanözü
25-29,349,338,687,Çankırı,Şabanözü
30-34,369,331,700,Çankırı,Şabanözü
35-39,407,353,760,Çankırı,Şabanözü
40-44,328,291,619,Çankırı,Şabanözü
45-49,320,304,624,Çankırı,Şabanözü
50-54,331,325,656,Çankırı,Şabanözü
55-59,339,349,688,Çankırı,Şabanözü
60-64,309,345,654,Çankırı,Şabanözü
65-69,296,305,601,Çankırı,Şabanözü
70-74,212,259,471,Çankırı,Şabanözü
75+,353,446,799,Çankırı,Şabanözü
18-24,1864,1979,3843,Ankara,Akyurt
25-29,1351,1311,2662,Ankara,Akyurt
30-34,1374,1315,2689,Ankara,Akyurt
35-39,1360,1296,2656,Ankara,Akyurt
40-44,1181,1119,2300,Ankara,Akyurt
45-49,1087,961,2048,Ankara,Akyurt
50-54,968,912,1880,Ankara,Akyurt
55-59,754,716,1470,Ankara,Akyurt
60-64,611,602,1213,Ankara,Akyurt
65-69,428,436,864,Ankara,Akyurt
70-74,232,299,531,Ankara,Akyurt
75+,333,404,737,Ankara,Akyurt
18-24,20298,19497,39795,İstanbul,Fatih
25-29,15507,13521,29028,İstanbul,Fatih
30-34,14746,13061,27807,İstanbul,Fatih
35-39,15331,14285,29616,İstanbul,Fatih
40-44,13900,13725,27625,İstanbul,Fatih
45-49,13089,13155,26244,İstanbul,Fatih
50-54,11795,11839,23634,İstanbul,Fatih
55-59,10532,10701,21233,İstanbul,Fatih
60-64,8804,9269,18073,İstanbul,Fatih
65-69,6482,7379,13861,İstanbul,Fatih
70-74,4281,5831,10112,İstanbul,Fatih
75+,5935,11028,16963,İstanbul,Fatih
18-24,2335,2414,4749,Afyonkarahisar,Dinar
25-29,1277,1349,2626,Afyonkarahisar,Dinar
30-34,1518,1427,2945,Afyonkarahisar,Dinar
35-39,1570,1526,3096,Afyonkarahisar,Dinar
40-44,1507,1465,2972,Afyonkarahisar,Dinar
45-49,1472,1626,3098,Afyonkarahisar,Dinar
50-54,1550,1543,3093,Afyonkarahisar,Dinar
55-59,1476,1600,3076,Afyonkarahisar,Dinar
60-64,1253,1410,2663,Afyonkarahisar,Dinar
65-69,1094,1247,2341,Afyonkarahisar,Dinar
70-74,680,887,1567,Afyonkarahisar,Dinar
75+,1162,1589,2751,Afyonkarahisar,Dinar
18-24,3775,3696,7471,Van,Muradiye
25-29,2335,1942,4277,Van,Muradiye
30-34,1738,1506,3244,Van,Muradiye
35-39,1300,1135,2435,Van,Muradiye
40-44,1229,994,2223,Van,Muradiye
45-49,978,911,1889,Van,Muradiye
50-54,847,804,1651,Van,Muradiye
55-59,654,676,1330,Van,Muradiye
60-64,485,538,1023,Van,Muradiye
65-69,332,378,710,Van,Muradiye
70-74,234,294,528,Van,Muradiye
75+,269,396,665,Van,Muradiye
18-24,887,946,1833,Erzurum,Narman
25-29,446,383,829,Erzurum,Narman
30-34,358,349,707,Erzurum,Narman
35-39,358,359,717,Erzurum,Narman
40-44,393,380,773,Erzurum,Narman
45-49,408,397,805,Erzurum,Narman
50-54,396,353,749,Erzurum,Narman
55-59,307,366,673,Erzurum,Narman
60-64,292,322,614,Erzurum,Narman
65-69,238,269,507,Erzurum,Narman
70-74,234,243,477,Erzurum,Narman
75+,358,421,779,Erzurum,Narman
18-24,295,306,601,Denizli,Beyağaç
25-29,210,176,386,Denizli,Beyağaç
30-34,242,174,416,Denizli,Beyağaç
35-39,249,219,468,Denizli,Beyağaç
40-44,250,198,448,Denizli,Beyağaç
45-49,244,215,459,Denizli,Beyağaç
50-54,239,247,486,Denizli,Beyağaç
55-59,246,286,532,Denizli,Beyağaç
60-64,213,210,423,Denizli,Beyağaç
65-69,151,187,338,Denizli,Beyağaç
70-74,130,133,263,Denizli,Beyağaç
75+,144,253,397,Denizli,Beyağaç
18-24,3400,3341,6741,Hatay,Hassa
25-29,1883,1610,3493,Hatay,Hassa
30-34,1840,1707,3547,Hatay,Hassa
35-39,1930,1844,3774,Hatay,Hassa
40-44,1699,1598,3297,Hatay,Hassa
45-49,1710,1626,3336,Hatay,Hassa
50-54,1708,1569,3277,Hatay,Hassa
55-59,1253,1257,2510,Hatay,Hassa
60-64,1004,1037,2041,Hatay,Hassa
65-69,673,847,1520,Hatay,Hassa
70-74,448,623,1071,Hatay,Hassa
75+,741,883,1624,Hatay,Hassa
18-24,2509,2632,5141,Manisa,Saruhanlı
25-29,1838,1547,3385,Manisa,Saruhanlı
30-34,1646,1494,3140,Manisa,Saruhanlı
35-39,1906,1778,3684,Manisa,Saruhanlı
40-44,1863,1795,3658,Manisa,Saruhanlı
45-49,1867,1903,3770,Manisa,Saruhanlı
50-54,1939,1887,3826,Manisa,Saruhanlı
55-59,1949,1886,3835,Manisa,Saruhanlı
60-64,1677,1746,3423,Manisa,Saruhanlı
65-69,1339,1467,2806,Manisa,Saruhanlı
70-74,888,1153,2041,Manisa,Saruhanlı
75+,1245,1950,3195,Manisa,Saruhanlı
18-24,981,967,1948,Adana,Pozantı
25-29,666,664,1330,Adana,Pozantı
30-34,693,598,1291,Adana,Pozantı
35-39,655,579,1234,Adana,Pozantı
40-44,597,601,1198,Adana,Pozantı
45-49,618,606,1224,Adana,Pozantı
50-54,605,590,1195,Adana,Pozantı
55-59,604,594,1198,Adana,Pozantı
60-64,519,575,1094,Adana,Pozantı
65-69,485,506,991,Adana,Pozantı
70-74,332,343,675,Adana,Pozantı
75+,511,614,1125,Adana,Pozantı
18-24,3942,4056,7998,Bursa,Orhangazi
25-29,2737,2695,5432,Bursa,Orhangazi
30-34,2982,2906,5888,Bursa,Orhangazi
35-39,3105,3109,6214,Bursa,Orhangazi
40-44,3123,2894,6017,Bursa,Orhangazi
45-49,2883,2780,5663,Bursa,Orhangazi
50-54,2563,2639,5202,Bursa,Orhangazi
55-59,2376,2278,4654,Bursa,Orhangazi
60-64,2020,2069,4089,Bursa,Orhangazi
65-69,1456,1551,3007,Bursa,Orhangazi
70-74,933,1166,2099,Bursa,Orhangazi
75+,1248,1854,3102,Bursa,Orhangazi
18-24,6723,6080,12803,Muğla,Menteşe
25-29,3981,3607,7588,Muğla,Menteşe
30-34,3928,3809,7737,Muğla,Menteşe
35-39,4094,4156,8250,Muğla,Menteşe
40-44,3938,3824,7762,Muğla,Menteşe
45-49,3511,3503,7014,Muğla,Menteşe
50-54,3281,3434,6715,Muğla,Menteşe
55-59,3279,3145,6424,Muğla,Menteşe
60-64,2785,2718,5503,Muğla,Menteşe
65-69,2048,2144,4192,Muğla,Menteşe
70-74,1312,1564,2876,Muğla,Menteşe
75+,2205,3415,5620,Muğla,Menteşe
18-24,469,428,897,Amasya,Göynücek
25-29,248,204,452,Amasya,Göynücek
30-34,240,235,475,Amasya,Göynücek
35-39,272,270,542,Amasya,Göynücek
40-44,253,262,515,Amasya,Göynücek
45-49,298,315,613,Amasya,Göynücek
50-54,380,365,745,Amasya,Göynücek
55-59,357,404,761,Amasya,Göynücek
60-64,454,393,847,Amasya,Göynücek
65-69,389,421,810,Amasya,Göynücek
70-74,309,351,660,Amasya,Göynücek
75+,371,514,885,Amasya,Göynücek
18-24,920,726,1646,Kahramanmaraş,Ekinözü
25-29,460,308,768,Kahramanmaraş,Ekinözü
30-34,415,269,684,Kahramanmaraş,Ekinözü
35-39,360,287,647,Kahramanmaraş,Ekinözü
40-44,280,343,623,Kahramanmaraş,Ekinözü
45-49,357,343,700,Kahramanmaraş,Ekinözü
50-54,330,313,643,Kahramanmaraş,Ekinözü
55-59,264,256,520,Kahramanmaraş,Ekinözü
60-64,275,206,481,Kahramanmaraş,Ekinözü
65-69,235,254,489,Kahramanmaraş,Ekinözü
70-74,190,254,444,Kahramanmaraş,Ekinözü
75+,285,374,659,Kahramanmaraş,Ekinözü
18-24,580,480,1060,İstanbul,Adalar
25-29,453,420,873,İstanbul,Adalar
30-34,509,430,939,İstanbul,Adalar
35-39,538,477,1015,İstanbul,Adalar
40-44,550,468,1018,İstanbul,Adalar
45-49,516,529,1045,İstanbul,Adalar
50-54,551,533,1084,İstanbul,Adalar
55-59,542,553,1095,İstanbul,Adalar
60-64,556,563,1119,İstanbul,Adalar
65-69,428,433,861,İstanbul,Adalar
70-74,355,377,732,İstanbul,Adalar
75+,486,640,1126,İstanbul,Adalar
18-24,3131,3337,6468,Konya,Seydişehir
25-29,1800,1879,3679,Konya,Seydişehir
30-34,2092,2095,4187,Konya,Seydişehir
35-39,2325,2392,4717,Konya,Seydişehir
40-44,2326,2301,4627,Konya,Seydişehir
45-49,1979,2060,4039,Konya,Seydişehir
50-54,1891,2046,3937,Konya,Seydişehir
55-59,1844,2045,3889,Konya,Seydişehir
60-64,1884,2031,3915,Konya,Seydişehir
65-69,1689,1706,3395,Konya,Seydişehir
70-74,1066,1213,2279,Konya,Seydişehir
75+,1339,1632,2971,Konya,Seydişehir
18-24,1360,1402,2762,Antalya,Demre
25-29,906,888,1794,Antalya,Demre
30-34,936,940,1876,Antalya,Demre
35-39,1081,1080,2161,Antalya,Demre
40-44,1059,1086,2145,Antalya,Demre
45-49,1158,1013,2171,Antalya,Demre
50-54,1005,825,1830,Antalya,Demre
55-59,733,684,1417,Antalya,Demre
60-64,579,508,1087,Antalya,Demre
65-69,396,400,796,Antalya,Demre
70-74,276,347,623,Antalya,Demre
75+,426,458,884,Antalya,Demre
18-24,724,723,1447,Elazığ,Baskil
25-29,376,326,702,Elazığ,Baskil
30-34,352,346,698,Elazığ,Baskil
35-39,423,384,807,Elazığ,Baskil
40-44,329,394,723,Elazığ,Baskil
45-49,418,413,831,Elazığ,Baskil
50-54,476,452,928,Elazığ,Baskil
55-59,425,431,856,Elazığ,Baskil
60-64,346,433,779,Elazığ,Baskil
65-69,306,396,702,Elazığ,Baskil
70-74,276,324,600,Elazığ,Baskil
75+,431,546,977,Elazığ,Baskil
18-24,661,618,1279,Çankırı,Çerkeş
25-29,448,474,922,Çankırı,Çerkeş
30-34,525,402,927,Çankırı,Çerkeş
35-39,512,439,951,Çankırı,Çerkeş
40-44,446,463,909,Çankırı,Çerkeş
45-49,516,431,947,Çankırı,Çerkeş
50-54,532,483,1015,Çankırı,Çerkeş
55-59,518,477,995,Çankırı,Çerkeş
60-64,508,522,1030,Çankırı,Çerkeş
65-69,435,470,905,Çankırı,Çerkeş
70-74,348,408,756,Çankırı,Çerkeş
75+,441,722,1163,Çankırı,Çerkeş
18-24,742,822,1564,Konya,Altınekin
25-29,500,449,949,Konya,Altınekin
30-34,508,467,975,Konya,Altınekin
35-39,486,488,974,Konya,Altınekin
40-44,469,385,854,Konya,Altınekin
45-49,434,440,874,Konya,Altınekin
50-54,421,382,803,Konya,Altınekin
55-59,359,336,695,Konya,Altınekin
60-64,297,348,645,Konya,Altınekin
65-69,253,310,563,Konya,Altınekin
70-74,143,185,328,Konya,Altınekin
75+,173,310,483,Konya,Altınekin
18-24,1418,1206,2624,Ağrı,Hamur
25-29,681,525,1206,Ağrı,Hamur
30-34,515,463,978,Ağrı,Hamur
35-39,492,490,982,Ağrı,Hamur
40-44,409,378,787,Ağrı,Hamur
45-49,321,328,649,Ağrı,Hamur
50-54,319,249,568,Ağrı,Hamur
55-59,261,207,468,Ağrı,Hamur
60-64,231,239,470,Ağrı,Hamur
65-69,161,177,338,Ağrı,Hamur
70-74,105,145,250,Ağrı,Hamur
75+,129,164,293,Ağrı,Hamur
18-24,1814,1824,3638,Kırşehir,Kaman
25-29,969,943,1912,Kırşehir,Kaman
30-34,1098,1034,2132,Kırşehir,Kaman
35-39,1177,1079,2256,Kırşehir,Kaman
40-44,1172,1158,2330,Kırşehir,Kaman
45-49,1231,1153,2384,Kırşehir,Kaman
50-54,1255,1207,2462,Kırşehir,Kaman
55-59,1240,1267,2507,Kırşehir,Kaman
60-64,1127,1196,2323,Kırşehir,Kaman
65-69,876,997,1873,Kırşehir,Kaman
70-74,563,775,1338,Kırşehir,Kaman
75+,829,1453,2282,Kırşehir,Kaman
18-24,534,521,1055,Bolu,Mengen
25-29,375,353,728,Bolu,Mengen
30-34,421,368,789,Bolu,Mengen
35-39,392,346,738,Bolu,Mengen
40-44,364,343,707,Bolu,Mengen
45-49,379,430,809,Bolu,Mengen
50-54,459,468,927,Bolu,Mengen
55-59,528,566,1094,Bolu,Mengen
60-64,584,551,1135,Bolu,Mengen
65-69,507,529,1036,Bolu,Mengen
70-74,345,401,746,Bolu,Mengen
75+,648,930,1578,Bolu,Mengen
18-24,974,1049,2023,Sinop,Gerze
25-29,719,713,1432,Sinop,Gerze
30-34,720,700,1420,Sinop,Gerze
35-39,799,758,1557,Sinop,Gerze
40-44,654,675,1329,Sinop,Gerze
45-49,637,757,1394,Sinop,Gerze
50-54,841,890,1731,Sinop,Gerze
55-59,839,979,1818,Sinop,Gerze
60-64,1004,909,1913,Sinop,Gerze
65-69,858,860,1718,Sinop,Gerze
70-74,567,639,1206,Sinop,Gerze
75+,927,1250,2177,Sinop,Gerze
18-24,40828,41042,81870,İstanbul,Küçükçekmece
25-29,31282,32021,63303,İstanbul,Küçükçekmece
30-34,33886,33624,67510,İstanbul,Küçükçekmece
35-39,35576,35732,71308,İstanbul,Küçükçekmece
40-44,31342,31060,62402,İstanbul,Küçükçekmece
45-49,27386,26026,53412,İstanbul,Küçükçekmece
50-54,21814,20851,42665,İstanbul,Küçükçekmece
55-59,16804,16232,33036,İstanbul,Küçükçekmece
60-64,11865,12373,24238,İstanbul,Küçükçekmece
65-69,7873,9120,16993,İstanbul,Küçükçekmece
70-74,4760,5983,10743,İstanbul,Küçükçekmece
75+,5131,8422,13553,İstanbul,Küçükçekmece
18-24,995,872,1867,Adana,Aladağ
25-29,569,484,1053,Adana,Aladağ
30-34,612,474,1086,Adana,Aladağ
35-39,659,486,1145,Adana,Aladağ
40-44,519,481,1000,Adana,Aladağ
45-49,484,443,927,Adana,Aladağ
50-54,442,446,888,Adana,Aladağ
55-59,462,480,942,Adana,Aladağ
60-64,429,464,893,Adana,Aladağ
65-69,335,346,681,Adana,Aladağ
70-74,255,318,573,Adana,Aladağ
75+,429,534,963,Adana,Aladağ
18-24,16881,17370,34251,Malatya,Yeşilyurt
25-29,10092,11465,21557,Malatya,Yeşilyurt
30-34,11814,12850,24664,Malatya,Yeşilyurt
35-39,12816,13908,26724,Malatya,Yeşilyurt
40-44,11690,11816,23506,Malatya,Yeşilyurt
45-49,10177,9782,19959,Malatya,Yeşilyurt
50-54,8467,8080,16547,Malatya,Yeşilyurt
55-59,6978,6788,13766,Malatya,Yeşilyurt
60-64,5646,5495,11141,Malatya,Yeşilyurt
65-69,4052,4244,8296,Malatya,Yeşilyurt
70-74,2547,2925,5472,Malatya,Yeşilyurt
75+,3236,4815,8051,Malatya,Yeşilyurt
18-24,18783,20666,39449,Hatay,Antakya
25-29,12559,13292,25851,Hatay,Antakya
30-34,13728,14177,27905,Hatay,Antakya
35-39,13956,14130,28086,Hatay,Antakya
40-44,12316,12157,24473,Hatay,Antakya
45-49,10782,10738,21520,Hatay,Antakya
50-54,9775,9603,19378,Hatay,Antakya
55-59,8156,8085,16241,Hatay,Antakya
60-64,5868,5922,11790,Hatay,Antakya
65-69,3976,4279,8255,Hatay,Antakya
70-74,2490,2940,5430,Hatay,Antakya
75+,3610,4386,7996,Hatay,Antakya
18-24,1448,1529,2977,Isparta,Eğirdir
25-29,939,928,1867,Isparta,Eğirdir
30-34,1126,998,2124,Isparta,Eğirdir
35-39,1111,1101,2212,Isparta,Eğirdir
40-44,1071,1027,2098,Isparta,Eğirdir
45-49,1075,1159,2234,Isparta,Eğirdir
50-54,1071,1055,2126,Isparta,Eğirdir
55-59,1036,1039,2075,Isparta,Eğirdir
60-64,915,966,1881,Isparta,Eğirdir
65-69,655,772,1427,Isparta,Eğirdir
70-74,469,607,1076,Isparta,Eğirdir
75+,841,1179,2020,Isparta,Eğirdir
18-24,7870,8395,16265,Diyarbakır,Bismil
25-29,4884,4775,9659,Diyarbakır,Bismil
30-34,3940,3856,7796,Diyarbakır,Bismil
35-39,3844,3962,7806,Diyarbakır,Bismil
40-44,2873,2911,5784,Diyarbakır,Bismil
45-49,2456,2379,4835,Diyarbakır,Bismil
50-54,2174,2089,4263,Diyarbakır,Bismil
55-59,1503,1466,2969,Diyarbakır,Bismil
60-64,1142,1170,2312,Diyarbakır,Bismil
65-69,891,1111,2002,Diyarbakır,Bismil
70-74,553,782,1335,Diyarbakır,Bismil
75+,806,1363,2169,Diyarbakır,Bismil
18-24,4277,4575,8852,Bitlis,Bitlis Merkez
25-29,3313,3125,6438,Bitlis,Bitlis Merkez
30-34,2700,2355,5055,Bitlis,Bitlis Merkez
35-39,2415,2127,4542,Bitlis,Bitlis Merkez
40-44,1741,1660,3401,Bitlis,Bitlis Merkez
45-49,1616,1392,3008,Bitlis,Bitlis Merkez
50-54,1352,1035,2387,Bitlis,Bitlis Merkez
55-59,1088,925,2013,Bitlis,Bitlis Merkez
60-64,818,867,1685,Bitlis,Bitlis Merkez
65-69,518,693,1211,Bitlis,Bitlis Merkez
70-74,362,481,843,Bitlis,Bitlis Merkez
75+,453,673,1126,Bitlis,Bitlis Merkez
18-24,4189,4529,8718,Kütahya,Tavşanlı
25-29,3191,3479,6670,Kütahya,Tavşanlı
30-34,3984,4009,7993,Kütahya,Tavşanlı
35-39,4221,4222,8443,Kütahya,Tavşanlı
40-44,3696,3699,7395,Kütahya,Tavşanlı
45-49,3154,3492,6646,Kütahya,Tavşanlı
50-54,3206,3584,6790,Kütahya,Tavşanlı
55-59,3642,3622,7264,Kütahya,Tavşanlı
60-64,2922,3002,5924,Kütahya,Tavşanlı
65-69,2166,2234,4400,Kütahya,Tavşanlı
70-74,1331,1552,2883,Kütahya,Tavşanlı
75+,1920,2590,4510,Kütahya,Tavşanlı
18-24,868,852,1720,Eskişehir,Sivrihisar
25-29,537,548,1085,Eskişehir,Sivrihisar
30-34,560,490,1050,Eskişehir,Sivrihisar
35-39,619,565,1184,Eskişehir,Sivrihisar
40-44,663,613,1276,Eskişehir,Sivrihisar
45-49,687,673,1360,Eskişehir,Sivrihisar
50-54,742,715,1457,Eskişehir,Sivrihisar
55-59,789,794,1583,Eskişehir,Sivrihisar
60-64,717,710,1427,Eskişehir,Sivrihisar
65-69,609,704,1313,Eskişehir,Sivrihisar
70-74,448,610,1058,Eskişehir,Sivrihisar
75+,747,1043,1790,Eskişehir,Sivrihisar
18-24,1273,1330,2603,Balıkesir,Havran
25-29,849,831,1680,Balıkesir,Havran
30-34,941,906,1847,Balıkesir,Havran
35-39,1000,956,1956,Balıkesir,Havran
40-44,949,891,1840,Balıkesir,Havran
45-49,898,874,1772,Balıkesir,Havran
50-54,919,876,1795,Balıkesir,Havran
55-59,910,899,1809,Balıkesir,Havran
60-64,752,731,1483,Balıkesir,Havran
65-69,651,627,1278,Balıkesir,Havran
70-74,413,532,945,Balıkesir,Havran
75+,681,1011,1692,Balıkesir,Havran
18-24,3348,3341,6689,Aydın,Didim
25-29,2582,2484,5066,Aydın,Didim
30-34,2746,2765,5511,Aydın,Didim
35-39,3138,2962,6100,Aydın,Didim
40-44,2800,2741,5541,Aydın,Didim
45-49,2572,2718,5290,Aydın,Didim
50-54,2885,3077,5962,Aydın,Didim
55-59,3296,3337,6633,Aydın,Didim
60-64,3368,3238,6606,Aydın,Didim
65-69,2705,2454,5159,Aydın,Didim
70-74,1773,1541,3314,Aydın,Didim
75+,1660,1684,3344,Aydın,Didim
18-24,2166,2424,4590,Hatay,Payas
25-29,1470,1563,3033,Hatay,Payas
30-34,1641,1599,3240,Hatay,Payas
35-39,1703,1614,3317,Hatay,Payas
40-44,1460,1345,2805,Hatay,Payas
45-49,1290,1311,2601,Hatay,Payas
50-54,1165,1012,2177,Hatay,Payas
55-59,841,897,1738,Hatay,Payas
60-64,650,722,1372,Hatay,Payas
65-69,579,557,1136,Hatay,Payas
70-74,287,338,625,Hatay,Payas
75+,291,430,721,Hatay,Payas
18-24,3597,3783,7380,Bilecik,Bozüyük
25-29,2735,2638,5373,Bilecik,Bozüyük
30-34,2991,2902,5893,Bilecik,Bozüyük
35-39,3191,3022,6213,Bilecik,Bozüyük
40-44,2762,2709,5471,Bilecik,Bozüyük
45-49,2612,2589,5201,Bilecik,Bozüyük
50-54,2463,2358,4821,Bilecik,Bozüyük
55-59,2154,2154,4308,Bilecik,Bozüyük
60-64,1738,1634,3372,Bilecik,Bozüyük
65-69,1018,1186,2204,Bilecik,Bozüyük
70-74,686,911,1597,Bilecik,Bozüyük
75+,1048,1557,2605,Bilecik,Bozüyük
18-24,2445,2624,5069,Bingöl,Solhan
25-29,1601,1547,3148,Bingöl,Solhan
30-34,1231,1057,2288,Bingöl,Solhan
35-39,1213,1155,2368,Bingöl,Solhan
40-44,979,1027,2006,Bingöl,Solhan
45-49,801,816,1617,Bingöl,Solhan
50-54,754,710,1464,Bingöl,Solhan
55-59,574,521,1095,Bingöl,Solhan
60-64,445,493,938,Bingöl,Solhan
65-69,329,431,760,Bingöl,Solhan
70-74,237,295,532,Bingöl,Solhan
75+,298,429,727,Bingöl,Solhan
18-24,324,337,661,Çorum,Ortaköy
25-29,226,178,404,Çorum,Ortaköy
30-34,208,184,392,Çorum,Ortaköy
35-39,212,164,376,Çorum,Ortaköy
40-44,197,169,366,Çorum,Ortaköy
45-49,172,211,383,Çorum,Ortaköy
50-54,227,246,473,Çorum,Ortaköy
55-59,227,238,465,Çorum,Ortaköy
60-64,255,216,471,Çorum,Ortaköy
65-69,211,282,493,Çorum,Ortaköy
70-74,176,219,395,Çorum,Ortaköy
75+,289,384,673,Çorum,Ortaköy
18-24,313,311,624,İzmir,Karaburun
25-29,308,257,565,İzmir,Karaburun
30-34,330,254,584,İzmir,Karaburun
35-39,333,273,606,İzmir,Karaburun
40-44,286,288,574,İzmir,Karaburun
45-49,310,318,628,İzmir,Karaburun
50-54,317,357,674,İzmir,Karaburun
55-59,430,473,903,İzmir,Karaburun
60-64,501,484,985,İzmir,Karaburun
65-69,437,420,857,İzmir,Karaburun
70-74,367,304,671,İzmir,Karaburun
75+,413,529,942,İzmir,Karaburun
18-24,6632,6213,12845,Muğla,Bodrum
25-29,5464,5323,10787,Muğla,Bodrum
30-34,6790,6481,13271,Muğla,Bodrum
35-39,8268,7680,15948,Muğla,Bodrum
40-44,7562,6888,14450,Muğla,Bodrum
45-49,6645,6019,12664,Muğla,Bodrum
50-54,5831,5419,11250,Muğla,Bodrum
55-59,5033,5177,10210,Muğla,Bodrum
60-64,4412,4751,9163,Muğla,Bodrum
65-69,3662,3934,7596,Muğla,Bodrum
70-74,2753,2840,5593,Muğla,Bodrum
75+,3359,3836,7195,Muğla,Bodrum
18-24,6618,6626,13244,Kırklareli,Lüleburgaz
25-29,5199,4966,10165,Kırklareli,Lüleburgaz
30-34,5710,5524,11234,Kırklareli,Lüleburgaz
35-39,6687,6399,13086,Kırklareli,Lüleburgaz
40-44,6016,6092,12108,Kırklareli,Lüleburgaz
45-49,5693,5441,11134,Kırklareli,Lüleburgaz
50-54,5066,4890,9956,Kırklareli,Lüleburgaz
55-59,4708,4900,9608,Kırklareli,Lüleburgaz
60-64,4031,3988,8019,Kırklareli,Lüleburgaz
65-69,2780,2965,5745,Kırklareli,Lüleburgaz
70-74,1628,1962,3590,Kırklareli,Lüleburgaz
75+,2156,3408,5564,Kırklareli,Lüleburgaz
18-24,21114,21312,42426,İstanbul,Başakşehir
25-29,13963,15252,29215,İstanbul,Başakşehir
30-34,15083,17267,32350,İstanbul,Başakşehir
35-39,17809,18945,36754,İstanbul,Başakşehir
40-44,16589,15865,32454,İstanbul,Başakşehir
45-49,13865,12119,25984,İstanbul,Başakşehir
50-54,10523,8759,19282,İstanbul,Başakşehir
55-59,7121,6367,13488,İstanbul,Başakşehir
60-64,4567,4298,8865,İstanbul,Başakşehir
65-69,2629,2909,5538,İstanbul,Başakşehir
70-74,1421,1887,3308,İstanbul,Başakşehir
75+,1577,2651,4228,İstanbul,Başakşehir
18-24,13176,12923,26099,İstanbul,Tuzla
25-29,10756,10879,21635,İstanbul,Tuzla
30-34,11699,11727,23426,İstanbul,Tuzla
35-39,12521,12153,24674,İstanbul,Tuzla
40-44,10748,9943,20691,İstanbul,Tuzla
45-49,8731,7949,16680,İstanbul,Tuzla
50-54,6829,6406,13235,İstanbul,Tuzla
55-59,5220,4674,9894,İstanbul,Tuzla
60-64,3501,3654,7155,İstanbul,Tuzla
65-69,2289,2430,4719,İstanbul,Tuzla
70-74,1314,1631,2945,İstanbul,Tuzla
75+,1432,2260,3692,İstanbul,Tuzla
18-24,798,828,1626,Trabzon,Çarşıbaşı
25-29,558,415,973,Trabzon,Çarşıbaşı
30-34,501,450,951,Trabzon,Çarşıbaşı
35-39,494,486,980,Trabzon,Çarşıbaşı
40-44,507,489,996,Trabzon,Çarşıbaşı
45-49,502,485,987,Trabzon,Çarşıbaşı
50-54,570,498,1068,Trabzon,Çarşıbaşı
55-59,516,521,1037,Trabzon,Çarşıbaşı
60-64,509,497,1006,Trabzon,Çarşıbaşı
65-69,356,334,690,Trabzon,Çarşıbaşı
70-74,191,310,501,Trabzon,Çarşıbaşı
75+,409,561,970,Trabzon,Çarşıbaşı
18-24,424,407,831,Bayburt,Aydıntepe
25-29,213,179,392,Bayburt,Aydıntepe
30-34,207,164,371,Bayburt,Aydıntepe
35-39,194,188,382,Bayburt,Aydıntepe
40-44,177,175,352,Bayburt,Aydıntepe
45-49,199,216,415,Bayburt,Aydıntepe
50-54,192,212,404,Bayburt,Aydıntepe
55-59,232,235,467,Bayburt,Aydıntepe
60-64,213,207,420,Bayburt,Aydıntepe
65-69,158,183,341,Bayburt,Aydıntepe
70-74,138,170,308,Bayburt,Aydıntepe
75+,210,281,491,Bayburt,Aydıntepe
18-24,2167,2456,4623,Aydın,Germencik
25-29,1530,1372,2902,Aydın,Germencik
30-34,1419,1359,2778,Aydın,Germencik
35-39,1511,1382,2893,Aydın,Germencik
40-44,1334,1364,2698,Aydın,Germencik
45-49,1305,1263,2568,Aydın,Germencik
50-54,1365,1251,2616,Aydın,Germencik
55-59,1269,1300,2569,Aydın,Germencik
60-64,1053,1226,2279,Aydın,Germencik
65-69,898,989,1887,Aydın,Germencik
70-74,668,806,1474,Aydın,Germencik
75+,1074,1629,2703,Aydın,Germencik
18-24,865,793,1658,Düzce,Çilimli
25-29,579,562,1141,Düzce,Çilimli
30-34,646,601,1247,Düzce,Çilimli
35-39,671,626,1297,Düzce,Çilimli
40-44,673,536,1209,Düzce,Çilimli
45-49,586,555,1141,Düzce,Çilimli
50-54,562,551,1113,Düzce,Çilimli
55-59,549,599,1148,Düzce,Çilimli
60-64,521,525,1046,Düzce,Çilimli
65-69,368,402,770,Düzce,Çilimli
70-74,249,286,535,Düzce,Çilimli
75+,326,459,785,Düzce,Çilimli
18-24,4625,4809,9434,Batman,Kozluk
25-29,2511,2491,5002,Batman,Kozluk
30-34,1637,1515,3152,Batman,Kozluk
35-39,1844,2069,3913,Batman,Kozluk
40-44,1519,1441,2960,Batman,Kozluk
45-49,1178,1136,2314,Batman,Kozluk
50-54,1116,931,2047,Batman,Kozluk
55-59,781,662,1443,Batman,Kozluk
60-64,555,687,1242,Batman,Kozluk
65-69,362,615,977,Batman,Kozluk
70-74,276,424,700,Batman,Kozluk
75+,440,762,1202,Batman,Kozluk
18-24,7114,7442,14556,Osmaniye,Kadirli
25-29,3814,3925,7739,Osmaniye,Kadirli
30-34,4098,4182,8280,Osmaniye,Kadirli
35-39,4542,4611,9153,Osmaniye,Kadirli
40-44,4208,4273,8481,Osmaniye,Kadirli
45-49,4137,4219,8356,Osmaniye,Kadirli
50-54,4000,3966,7966,Osmaniye,Kadirli
55-59,3496,3375,6871,Osmaniye,Kadirli
60-64,2846,2870,5716,Osmaniye,Kadirli
65-69,2200,2275,4475,Osmaniye,Kadirli
70-74,1369,1688,3057,Osmaniye,Kadirli
75+,1767,2713,4480,Osmaniye,Kadirli
18-24,1786,1768,3554,İzmir,Seferihisar
25-29,1280,1215,2495,İzmir,Seferihisar
30-34,1296,1278,2574,İzmir,Seferihisar
35-39,1387,1559,2946,İzmir,Seferihisar
40-44,1403,1352,2755,İzmir,Seferihisar
45-49,1349,1427,2776,İzmir,Seferihisar
50-54,1420,1529,2949,İzmir,Seferihisar
55-59,1452,1482,2934,İzmir,Seferihisar
60-64,1412,1395,2807,İzmir,Seferihisar
65-69,1211,1213,2424,İzmir,Seferihisar
70-74,837,812,1649,İzmir,Seferihisar
75+,998,1095,2093,İzmir,Seferihisar
18-24,191,193,384,Erzurum,Pazaryolu
25-29,117,100,217,Erzurum,Pazaryolu
30-34,92,80,172,Erzurum,Pazaryolu
35-39,82,72,154,Erzurum,Pazaryolu
40-44,77,81,158,Erzurum,Pazaryolu
45-49,98,112,210,Erzurum,Pazaryolu
50-54,125,148,273,Erzurum,Pazaryolu
55-59,159,183,342,Erzurum,Pazaryolu
60-64,208,209,417,Erzurum,Pazaryolu
65-69,165,135,300,Erzurum,Pazaryolu
70-74,126,146,272,Erzurum,Pazaryolu
75+,227,296,523,Erzurum,Pazaryolu
18-24,901,807,1708,Balıkesir,Savaştepe
25-29,536,517,1053,Balıkesir,Savaştepe
30-34,508,479,987,Balıkesir,Savaştepe
35-39,564,545,1109,Balıkesir,Savaştepe
40-44,579,587,1166,Balıkesir,Savaştepe
45-49,702,706,1408,Balıkesir,Savaştepe
50-54,712,696,1408,Balıkesir,Savaştepe
55-59,642,583,1225,Balıkesir,Savaştepe
60-64,497,563,1060,Balıkesir,Savaştepe
65-69,380,488,868,Balıkesir,Savaştepe
70-74,383,429,812,Balıkesir,Savaştepe
75+,611,857,1468,Balıkesir,Savaştepe
18-24,850,775,1625,Kastamonu,Cide
25-29,584,521,1105,Kastamonu,Cide
30-34,598,510,1108,Kastamonu,Cide
35-39,584,508,1092,Kastamonu,Cide
40-44,537,494,1031,Kastamonu,Cide
45-49,592,548,1140,Kastamonu,Cide
50-54,722,680,1402,Kastamonu,Cide
55-59,939,905,1844,Kastamonu,Cide
60-64,1072,1053,2125,Kastamonu,Cide
65-69,846,880,1726,Kastamonu,Cide
70-74,643,701,1344,Kastamonu,Cide
75+,1100,1405,2505,Kastamonu,Cide
18-24,378,357,735,Kastamonu,Daday
25-29,258,208,466,Kastamonu,Daday
30-34,223,219,442,Kastamonu,Daday
35-39,260,204,464,Kastamonu,Daday
40-44,240,235,475,Kastamonu,Daday
45-49,275,290,565,Kastamonu,Daday
50-54,290,329,619,Kastamonu,Daday
55-59,318,319,637,Kastamonu,Daday
60-64,343,359,702,Kastamonu,Daday
65-69,263,291,554,Kastamonu,Daday
70-74,179,253,432,Kastamonu,Daday
75+,375,575,950,Kastamonu,Daday
18-24,1741,1613,3354,Ordu,Kumru
25-29,949,866,1815,Ordu,Kumru
30-34,960,866,1826,Ordu,Kumru
35-39,1035,953,1988,Ordu,Kumru
40-44,857,898,1755,Ordu,Kumru
45-49,864,811,1675,Ordu,Kumru
50-54,945,911,1856,Ordu,Kumru
55-59,849,844,1693,Ordu,Kumru
60-64,853,995,1848,Ordu,Kumru
65-69,687,740,1427,Ordu,Kumru
70-74,512,640,1152,Ordu,Kumru
75+,830,1078,1908,Ordu,Kumru
18-24,4941,5499,10440,Diyarbakır,Çınar
25-29,3009,2827,5836,Diyarbakır,Çınar
30-34,1886,1865,3751,Diyarbakır,Çınar
35-39,2126,2214,4340,Diyarbakır,Çınar
40-44,1515,1688,3203,Diyarbakır,Çınar
45-49,1363,1276,2639,Diyarbakır,Çınar
50-54,1224,1055,2279,Diyarbakır,Çınar
55-59,675,770,1445,Diyarbakır,Çınar
60-64,542,605,1147,Diyarbakır,Çınar
65-69,460,558,1018,Diyarbakır,Çınar
70-74,296,428,724,Diyarbakır,Çınar
75+,467,675,1142,Diyarbakır,Çınar
18-24,342,313,655,Antalya,Gündoğmuş
25-29,239,188,427,Antalya,Gündoğmuş
30-34,186,126,312,Antalya,Gündoğmuş
35-39,158,153,311,Antalya,Gündoğmuş
40-44,187,194,381,Antalya,Gündoğmuş
45-49,188,210,398,Antalya,Gündoğmuş
50-54,235,276,511,Antalya,Gündoğmuş
55-59,227,290,517,Antalya,Gündoğmuş
60-64,258,295,553,Antalya,Gündoğmuş
65-69,241,291,532,Antalya,Gündoğmuş
70-74,192,246,438,Antalya,Gündoğmuş
75+,515,593,1108,Antalya,Gündoğmuş
18-24,2557,2506,5063,Antalya,Finike
25-29,1616,1667,3283,Antalya,Finike
30-34,1715,1758,3473,Antalya,Finike
35-39,1836,1820,3656,Antalya,Finike
40-44,1746,1766,3512,Antalya,Finike
45-49,1725,1770,3495,Antalya,Finike
50-54,1665,1636,3301,Antalya,Finike
55-59,1552,1526,3078,Antalya,Finike
60-64,1292,1233,2525,Antalya,Finike
65-69,944,860,1804,Antalya,Finike
70-74,537,614,1151,Antalya,Finike
75+,823,1097,1920,Antalya,Finike
18-24,999,1026,2025,Erzincan,Tercan
25-29,600,556,1156,Erzincan,Tercan
30-34,614,470,1084,Erzincan,Tercan
35-39,595,520,1115,Erzincan,Tercan
40-44,613,484,1097,Erzincan,Tercan
45-49,545,456,1001,Erzincan,Tercan
50-54,489,473,962,Erzincan,Tercan
55-59,429,416,845,Erzincan,Tercan
60-64,355,386,741,Erzincan,Tercan
65-69,335,354,689,Erzincan,Tercan
70-74,248,283,531,Erzincan,Tercan
75+,333,432,765,Erzincan,Tercan
18-24,328,362,690,Kırıkkale,Bahşili
25-29,232,228,460,Kırıkkale,Bahşili
30-34,261,233,494,Kırıkkale,Bahşili
35-39,271,213,484,Kırıkkale,Bahşili
40-44,206,215,421,Kırıkkale,Bahşili
45-49,232,220,452,Kırıkkale,Bahşili
50-54,226,254,480,Kırıkkale,Bahşili
55-59,232,254,486,Kırıkkale,Bahşili
60-64,220,200,420,Kırıkkale,Bahşili
65-69,152,188,340,Kırıkkale,Bahşili
70-74,109,104,213,Kırıkkale,Bahşili
75+,124,171,295,Kırıkkale,Bahşili
18-24,1974,2026,4000,Zonguldak,Kozlu
25-29,1480,1488,2968,Zonguldak,Kozlu
30-34,1812,1849,3661,Zonguldak,Kozlu
35-39,1878,1756,3634,Zonguldak,Kozlu
40-44,1622,1636,3258,Zonguldak,Kozlu
45-49,1482,1545,3027,Zonguldak,Kozlu
50-54,1401,1619,3020,Zonguldak,Kozlu
55-59,1570,1637,3207,Zonguldak,Kozlu
60-64,1330,1385,2715,Zonguldak,Kozlu
65-69,954,1002,1956,Zonguldak,Kozlu
70-74,567,612,1179,Zonguldak,Kozlu
75+,602,981,1583,Zonguldak,Kozlu
18-24,2636,2607,5243,Antalya,Korkuteli
25-29,1675,1579,3254,Antalya,Korkuteli
30-34,1659,1635,3294,Antalya,Korkuteli
35-39,1878,1723,3601,Antalya,Korkuteli
40-44,1817,1773,3590,Antalya,Korkuteli
45-49,1796,1782,3578,Antalya,Korkuteli
50-54,1800,1925,3725,Antalya,Korkuteli
55-59,1650,1781,3431,Antalya,Korkuteli
60-64,1531,1613,3144,Antalya,Korkuteli
65-69,1175,1318,2493,Antalya,Korkuteli
70-74,1006,1127,2133,Antalya,Korkuteli
75+,1595,1831,3426,Antalya,Korkuteli
18-24,3670,3751,7421,Burdur,Bucak
25-29,2105,1975,4080,Burdur,Bucak
30-34,2067,2071,4138,Burdur,Bucak
35-39,2377,2203,4580,Burdur,Bucak
40-44,2251,2257,4508,Burdur,Bucak
45-49,2230,2217,4447,Burdur,Bucak
50-54,2103,2045,4148,Burdur,Bucak
55-59,1929,1913,3842,Burdur,Bucak
60-64,1573,1736,3309,Burdur,Bucak
65-69,1231,1336,2567,Burdur,Bucak
70-74,799,1039,1838,Burdur,Bucak
75+,1244,1842,3086,Burdur,Bucak
18-24,550,515,1065,Uşak,Ulubey
25-29,323,297,620,Uşak,Ulubey
30-34,380,318,698,Uşak,Ulubey
35-39,368,332,700,Uşak,Ulubey
40-44,402,414,816,Uşak,Ulubey
45-49,454,462,916,Uşak,Ulubey
50-54,478,499,977,Uşak,Ulubey
55-59,496,508,1004,Uşak,Ulubey
60-64,505,535,1040,Uşak,Ulubey
65-69,429,454,883,Uşak,Ulubey
70-74,254,349,603,Uşak,Ulubey
75+,528,745,1273,Uşak,Ulubey
18-24,9767,11226,20993,Şanlıurfa,Karaköprü
25-29,7851,8927,16778,Şanlıurfa,Karaköprü
30-34,7706,7760,15466,Şanlıurfa,Karaköprü
35-39,6844,6718,13562,Şanlıurfa,Karaköprü
40-44,5357,4981,10338,Şanlıurfa,Karaköprü
45-49,4018,3614,7632,Şanlıurfa,Karaköprü
50-54,3464,3069,6533,Şanlıurfa,Karaköprü
55-59,2519,2308,4827,Şanlıurfa,Karaköprü
60-64,1808,1543,3351,Şanlıurfa,Karaköprü
65-69,1274,1177,2451,Şanlıurfa,Karaköprü
70-74,751,833,1584,Şanlıurfa,Karaköprü
75+,739,1140,1879,Şanlıurfa,Karaköprü
18-24,3050,3352,6402,Niğde,Bor
25-29,1943,1894,3837,Niğde,Bor
30-34,2023,2022,4045,Niğde,Bor
35-39,2030,2138,4168,Niğde,Bor
40-44,1980,1992,3972,Niğde,Bor
45-49,1946,1933,3879,Niğde,Bor
50-54,1800,1889,3689,Niğde,Bor
55-59,1704,1793,3497,Niğde,Bor
60-64,1385,1470,2855,Niğde,Bor
65-69,1018,1208,2226,Niğde,Bor
70-74,812,1050,1862,Niğde,Bor
75+,1231,1842,3073,Niğde,Bor
18-24,42938,44060,86998,Bursa,Osmangazi
25-29,33442,33044,66486,Bursa,Osmangazi
30-34,36362,35365,71727,Bursa,Osmangazi
35-39,39006,37768,76774,Bursa,Osmangazi
40-44,34255,33643,67898,Bursa,Osmangazi
45-49,30475,29718,60193,Bursa,Osmangazi
50-54,26434,25765,52199,Bursa,Osmangazi
55-59,22206,22160,44366,Bursa,Osmangazi
60-64,17292,18406,35698,Bursa,Osmangazi
65-69,12532,13987,26519,Bursa,Osmangazi
70-74,7567,9845,17412,Bursa,Osmangazi
75+,9818,15142,24960,Bursa,Osmangazi
18-24,2619,2840,5459,Trabzon,Araklı
25-29,1760,1655,3415,Trabzon,Araklı
30-34,1719,1592,3311,Trabzon,Araklı
35-39,1722,1614,3336,Trabzon,Araklı
40-44,1494,1335,2829,Trabzon,Araklı
45-49,1347,1273,2620,Trabzon,Araklı
50-54,1349,1392,2741,Trabzon,Araklı
55-59,1209,1301,2510,Trabzon,Araklı
60-64,1145,1292,2437,Trabzon,Araklı
65-69,864,968,1832,Trabzon,Araklı
70-74,588,847,1435,Trabzon,Araklı
75+,867,1552,2419,Trabzon,Araklı
18-24,2052,2160,4212,Bingöl,Karlıova
25-29,1381,1130,2511,Bingöl,Karlıova
30-34,1020,929,1949,Bingöl,Karlıova
35-39,945,982,1927,Bingöl,Karlıova
40-44,728,750,1478,Bingöl,Karlıova
45-49,766,662,1428,Bingöl,Karlıova
50-54,625,658,1283,Bingöl,Karlıova
55-59,496,460,956,Bingöl,Karlıova
60-64,487,515,1002,Bingöl,Karlıova
65-69,406,413,819,Bingöl,Karlıova
70-74,234,314,548,Bingöl,Karlıova
75+,290,441,731,Bingöl,Karlıova
18-24,406,403,809,Uşak,Karahallı
25-29,255,235,490,Uşak,Karahallı
30-34,349,279,628,Uşak,Karahallı
35-39,364,287,651,Uşak,Karahallı
40-44,348,316,664,Uşak,Karahallı
45-49,317,313,630,Uşak,Karahallı
50-54,303,313,616,Uşak,Karahallı
55-59,395,379,774,Uşak,Karahallı
60-64,397,431,828,Uşak,Karahallı
65-69,351,409,760,Uşak,Karahallı
70-74,259,355,614,Uşak,Karahallı
75+,393,634,1027,Uşak,Karahallı
18-24,3813,4058,7871,Konya,Çumra
25-29,2373,2093,4466,Konya,Çumra
30-34,2441,2240,4681,Konya,Çumra
35-39,2326,2133,4459,Konya,Çumra
40-44,2085,2051,4136,Konya,Çumra
45-49,1980,2044,4024,Konya,Çumra
50-54,1930,1877,3807,Konya,Çumra
55-59,1640,1674,3314,Konya,Çumra
60-64,1372,1563,2935,Konya,Çumra
65-69,1088,1262,2350,Konya,Çumra
70-74,613,850,1463,Konya,Çumra
75+,995,1508,2503,Konya,Çumra
18-24,6222,6296,12518,Diyarbakır,Silvan
25-29,3635,3525,7160,Diyarbakır,Silvan
30-34,2754,2565,5319,Diyarbakır,Silvan
35-39,2678,2862,5540,Diyarbakır,Silvan
40-44,2123,2079,4202,Diyarbakır,Silvan
45-49,1768,1720,3488,Diyarbakır,Silvan
50-54,1560,1434,2994,Diyarbakır,Silvan
55-59,1026,1086,2112,Diyarbakır,Silvan
60-64,868,848,1716,Diyarbakır,Silvan
65-69,629,816,1445,Diyarbakır,Silvan
70-74,454,570,1024,Diyarbakır,Silvan
75+,613,1077,1690,Diyarbakır,Silvan
18-24,2183,1928,4111,Ağrı,Tutak
25-29,1195,1061,2256,Ağrı,Tutak
30-34,856,837,1693,Ağrı,Tutak
35-39,991,947,1938,Ağrı,Tutak
40-44,755,654,1409,Ağrı,Tutak
45-49,651,575,1226,Ağrı,Tutak
50-54,584,466,1050,Ağrı,Tutak
55-59,486,439,925,Ağrı,Tutak
60-64,402,463,865,Ağrı,Tutak
65-69,274,343,617,Ağrı,Tutak
70-74,242,226,468,Ağrı,Tutak
75+,249,378,627,Ağrı,Tutak
18-24,230,230,460,Konya,Halkapınar
25-29,119,71,190,Konya,Halkapınar
30-34,113,87,200,Konya,Halkapınar
35-39,125,139,264,Konya,Halkapınar
40-44,138,126,264,Konya,Halkapınar
45-49,167,157,324,Konya,Halkapınar
50-54,132,165,297,Konya,Halkapınar
55-59,139,145,284,Konya,Halkapınar
60-64,144,162,306,Konya,Halkapınar
65-69,109,147,256,Konya,Halkapınar
70-74,85,98,183,Konya,Halkapınar
75+,98,153,251,Konya,Halkapınar
18-24,179,191,370,Kayseri,Özvatan
25-29,106,93,199,Kayseri,Özvatan
30-34,131,88,219,Kayseri,Özvatan
35-39,94,84,178,Kayseri,Özvatan
40-44,98,99,197,Kayseri,Özvatan
45-49,128,147,275,Kayseri,Özvatan
50-54,160,153,313,Kayseri,Özvatan
55-59,168,172,340,Kayseri,Özvatan
60-64,168,138,306,Kayseri,Özvatan
65-69,150,147,297,Kayseri,Özvatan
70-74,95,137,232,Kayseri,Özvatan
75+,182,274,456,Kayseri,Özvatan
18-24,569,534,1103,İzmir,Beydağ
25-29,367,340,707,İzmir,Beydağ
30-34,428,400,828,İzmir,Beydağ
35-39,446,451,897,İzmir,Beydağ
40-44,469,387,856,İzmir,Beydağ
45-49,420,414,834,İzmir,Beydağ
50-54,472,466,938,İzmir,Beydağ
55-59,479,478,957,İzmir,Beydağ
60-64,400,403,803,İzmir,Beydağ
65-69,336,341,677,İzmir,Beydağ
70-74,218,292,510,İzmir,Beydağ
75+,314,548,862,İzmir,Beydağ
18-24,501,534,1035,Erzincan,Çayırlı
25-29,263,250,513,Erzincan,Çayırlı
30-34,280,262,542,Erzincan,Çayırlı
35-39,287,272,559,Erzincan,Çayırlı
40-44,341,262,603,Erzincan,Çayırlı
45-49,316,267,583,Erzincan,Çayırlı
50-54,312,305,617,Erzincan,Çayırlı
55-59,306,282,588,Erzincan,Çayırlı
60-64,264,253,517,Erzincan,Çayırlı
65-69,243,233,476,Erzincan,Çayırlı
70-74,162,200,362,Erzincan,Çayırlı
75+,215,280,495,Erzincan,Çayırlı
18-24,700,602,1302,Gaziantep,Karkamış
25-29,426,302,728,Gaziantep,Karkamış
30-34,276,248,524,Gaziantep,Karkamış
35-39,293,271,564,Gaziantep,Karkamış
40-44,268,261,529,Gaziantep,Karkamış
45-49,246,255,501,Gaziantep,Karkamış
50-54,293,254,547,Gaziantep,Karkamış
55-59,211,214,425,Gaziantep,Karkamış
60-64,199,203,402,Gaziantep,Karkamış
65-69,177,241,418,Gaziantep,Karkamış
70-74,111,168,279,Gaziantep,Karkamış
75+,194,319,513,Gaziantep,Karkamış
18-24,1223,1148,2371,Nevşehir,Acıgöl
25-29,660,516,1176,Nevşehir,Acıgöl
30-34,652,636,1288,Nevşehir,Acıgöl
35-39,670,569,1239,Nevşehir,Acıgöl
40-44,623,581,1204,Nevşehir,Acıgöl
45-49,551,538,1089,Nevşehir,Acıgöl
50-54,509,527,1036,Nevşehir,Acıgöl
55-59,457,489,946,Nevşehir,Acıgöl
60-64,431,482,913,Nevşehir,Acıgöl
65-69,387,452,839,Nevşehir,Acıgöl
70-74,272,368,640,Nevşehir,Acıgöl
75+,382,468,850,Nevşehir,Acıgöl
18-24,1457,1292,2749,Siirt,Eruh
25-29,1073,636,1709,Siirt,Eruh
30-34,591,490,1081,Siirt,Eruh
35-39,513,514,1027,Siirt,Eruh
40-44,315,307,622,Siirt,Eruh
45-49,359,291,650,Siirt,Eruh
50-54,283,261,544,Siirt,Eruh
55-59,182,195,377,Siirt,Eruh
60-64,252,241,493,Siirt,Eruh
65-69,199,195,394,Siirt,Eruh
70-74,142,208,350,Siirt,Eruh
75+,226,352,578,Siirt,Eruh
18-24,2246,2391,4637,Manisa,Kula
25-29,1216,1255,2471,Manisa,Kula
30-34,1454,1433,2887,Manisa,Kula
35-39,1613,1615,3228,Manisa,Kula
40-44,1587,1567,3154,Manisa,Kula
45-49,1707,1749,3456,Manisa,Kula
50-54,1661,1714,3375,Manisa,Kula
55-59,1536,1614,3150,Manisa,Kula
60-64,1252,1275,2527,Manisa,Kula
65-69,956,1045,2001,Manisa,Kula
70-74,670,789,1459,Manisa,Kula
75+,987,1371,2358,Manisa,Kula
18-24,554,615,1169,Aydın,Buharkent
25-29,420,389,809,Aydın,Buharkent
30-34,462,440,902,Aydın,Buharkent
35-39,510,452,962,Aydın,Buharkent
40-44,423,399,822,Aydın,Buharkent
45-49,411,406,817,Aydın,Buharkent
50-54,417,438,855,Aydın,Buharkent
55-59,425,430,855,Aydın,Buharkent
60-64,326,315,641,Aydın,Buharkent
65-69,249,293,542,Aydın,Buharkent
70-74,182,230,412,Aydın,Buharkent
75+,253,484,737,Aydın,Buharkent
18-24,148,128,276,Sinop,Saraydüzü
25-29,98,74,172,Sinop,Saraydüzü
30-34,100,85,185,Sinop,Saraydüzü
35-39,106,76,182,Sinop,Saraydüzü
40-44,97,71,168,Sinop,Saraydüzü
45-49,108,98,206,Sinop,Saraydüzü
50-54,180,158,338,Sinop,Saraydüzü
55-59,244,256,500,Sinop,Saraydüzü
60-64,326,293,619,Sinop,Saraydüzü
65-69,307,313,620,Sinop,Saraydüzü
70-74,229,288,517,Sinop,Saraydüzü
75+,345,476,821,Sinop,Saraydüzü
18-24,8360,8722,17082,Erzincan,Erzincan Merkez
25-29,5098,5368,10466,Erzincan,Erzincan Merkez
30-34,5466,5711,11177,Erzincan,Erzincan Merkez
35-39,5737,5833,11570,Erzincan,Erzincan Merkez
40-44,5181,5096,10277,Erzincan,Erzincan Merkez
45-49,4668,4717,9385,Erzincan,Erzincan Merkez
50-54,4206,4294,8500,Erzincan,Erzincan Merkez
55-59,3676,3736,7412,Erzincan,Erzincan Merkez
60-64,3160,3323,6483,Erzincan,Erzincan Merkez
65-69,2489,2565,5054,Erzincan,Erzincan Merkez
70-74,1636,2054,3690,Erzincan,Erzincan Merkez
75+,2241,3553,5794,Erzincan,Erzincan Merkez
18-24,629,608,1237,Manisa,Köprübaşı
25-29,327,328,655,Manisa,Köprübaşı
30-34,356,322,678,Manisa,Köprübaşı
35-39,363,354,717,Manisa,Köprübaşı
40-44,427,465,892,Manisa,Köprübaşı
45-49,511,526,1037,Manisa,Köprübaşı
50-54,592,641,1233,Manisa,Köprübaşı
55-59,570,567,1137,Manisa,Köprübaşı
60-64,507,571,1078,Manisa,Köprübaşı
65-69,392,404,796,Manisa,Köprübaşı
70-74,246,306,552,Manisa,Köprübaşı
75+,365,490,855,Manisa,Köprübaşı
18-24,8959,9087,18046,Tekirdağ,Çerkezköy
25-29,7608,7349,14957,Tekirdağ,Çerkezköy
30-34,7888,7450,15338,Tekirdağ,Çerkezköy
35-39,8091,7411,15502,Tekirdağ,Çerkezköy
40-44,6469,5656,12125,Tekirdağ,Çerkezköy
45-49,5142,4541,9683,Tekirdağ,Çerkezköy
50-54,3845,3375,7220,Tekirdağ,Çerkezköy
55-59,2787,2530,5317,Tekirdağ,Çerkezköy
60-64,1948,1926,3874,Tekirdağ,Çerkezköy
65-69,1159,1185,2344,Tekirdağ,Çerkezköy
70-74,604,724,1328,Tekirdağ,Çerkezköy
75+,652,999,1651,Tekirdağ,Çerkezköy
18-24,7654,7799,15453,Samsun,Çarşamba
25-29,4427,4375,8802,Samsun,Çarşamba
30-34,4597,4631,9228,Samsun,Çarşamba
35-39,5044,5008,10052,Samsun,Çarşamba
40-44,4594,4453,9047,Samsun,Çarşamba
45-49,4123,4257,8380,Samsun,Çarşamba
50-54,4640,4604,9244,Samsun,Çarşamba
55-59,4282,4103,8385,Samsun,Çarşamba
60-64,3630,3565,7195,Samsun,Çarşamba
65-69,2864,2873,5737,Samsun,Çarşamba
70-74,1839,2234,4073,Samsun,Çarşamba
75+,2326,3773,6099,Samsun,Çarşamba
18-24,23242,25124,48366,Şanlıurfa,Haliliye
25-29,16034,15792,31826,Şanlıurfa,Haliliye
30-34,13696,13372,27068,Şanlıurfa,Haliliye
35-39,12219,11902,24121,Şanlıurfa,Haliliye
40-44,9401,9204,18605,Şanlıurfa,Haliliye
45-49,7474,7266,14740,Şanlıurfa,Haliliye
50-54,6698,6529,13227,Şanlıurfa,Haliliye
55-59,4809,5211,10020,Şanlıurfa,Haliliye
60-64,3776,3698,7474,Şanlıurfa,Haliliye
65-69,2642,2776,5418,Şanlıurfa,Haliliye
70-74,1671,1937,3608,Şanlıurfa,Haliliye
75+,1839,3166,5005,Şanlıurfa,Haliliye
18-24,622,606,1228,Isparta,Gelendost
25-29,442,404,846,Isparta,Gelendost
30-34,521,420,941,Isparta,Gelendost
35-39,496,454,950,Isparta,Gelendost
40-44,442,431,873,Isparta,Gelendost
45-49,495,519,1014,Isparta,Gelendost
50-54,578,591,1169,Isparta,Gelendost
55-59,600,601,1201,Isparta,Gelendost
60-64,540,628,1168,Isparta,Gelendost
65-69,468,510,978,Isparta,Gelendost
70-74,280,388,668,Isparta,Gelendost
75+,511,710,1221,Isparta,Gelendost
18-24,1632,1649,3281,Afyonkarahisar,İhsaniye
25-29,997,904,1901,Afyonkarahisar,İhsaniye
30-34,1012,936,1948,Afyonkarahisar,İhsaniye
35-39,942,907,1849,Afyonkarahisar,İhsaniye
40-44,876,884,1760,Afyonkarahisar,İhsaniye
45-49,838,825,1663,Afyonkarahisar,İhsaniye
50-54,791,792,1583,Afyonkarahisar,İhsaniye
55-59,787,758,1545,Afyonkarahisar,İhsaniye
60-64,567,637,1204,Afyonkarahisar,İhsaniye
65-69,482,539,1021,Afyonkarahisar,İhsaniye
70-74,335,414,749,Afyonkarahisar,İhsaniye
75+,595,777,1372,Afyonkarahisar,İhsaniye
18-24,1366,1318,2684,Samsun,Alaçam
25-29,604,630,1234,Samsun,Alaçam
30-34,549,606,1155,Samsun,Alaçam
35-39,614,685,1299,Samsun,Alaçam
40-44,729,781,1510,Samsun,Alaçam
45-49,832,878,1710,Samsun,Alaçam
50-54,988,919,1907,Samsun,Alaçam
55-59,980,955,1935,Samsun,Alaçam
60-64,854,844,1698,Samsun,Alaçam
65-69,751,855,1606,Samsun,Alaçam
70-74,629,661,1290,Samsun,Alaçam
75+,863,1268,2131,Samsun,Alaçam
18-24,412,368,780,Kırklareli,Demirköy
25-29,334,252,586,Kırklareli,Demirköy
30-34,286,210,496,Kırklareli,Demirköy
35-39,276,245,521,Kırklareli,Demirköy
40-44,260,203,463,Kırklareli,Demirköy
45-49,305,253,558,Kırklareli,Demirköy
50-54,340,298,638,Kırklareli,Demirköy
55-59,356,293,649,Kırklareli,Demirköy
60-64,295,308,603,Kırklareli,Demirköy
65-69,258,238,496,Kırklareli,Demirköy
70-74,168,170,338,Kırklareli,Demirköy
75+,230,310,540,Kırklareli,Demirköy
18-24,950,925,1875,Uşak,Sivaslı
25-29,599,602,1201,Uşak,Sivaslı
30-34,682,631,1313,Uşak,Sivaslı
35-39,773,702,1475,Uşak,Sivaslı
40-44,752,667,1419,Uşak,Sivaslı
45-49,694,619,1313,Uşak,Sivaslı
50-54,643,628,1271,Uşak,Sivaslı
55-59,671,708,1379,Uşak,Sivaslı
60-64,616,622,1238,Uşak,Sivaslı
65-69,449,544,993,Uşak,Sivaslı
70-74,338,456,794,Uşak,Sivaslı
75+,533,801,1334,Uşak,Sivaslı
18-24,274,210,484,Bingöl,Kiğı
25-29,462,183,645,Bingöl,Kiğı
30-34,213,121,334,Bingöl,Kiğı
35-39,188,140,328,Bingöl,Kiğı
40-44,157,110,267,Bingöl,Kiğı
45-49,147,110,257,Bingöl,Kiğı
50-54,112,101,213,Bingöl,Kiğı
55-59,138,139,277,Bingöl,Kiğı
60-64,135,156,291,Bingöl,Kiğı
65-69,138,125,263,Bingöl,Kiğı
70-74,73,82,155,Bingöl,Kiğı
75+,169,185,354,Bingöl,Kiğı
18-24,2411,2303,4714,Bingöl,Genç
25-29,1835,1453,3288,Bingöl,Genç
30-34,1355,1182,2537,Bingöl,Genç
35-39,1190,1220,2410,Bingöl,Genç
40-44,1040,912,1952,Bingöl,Genç
45-49,877,864,1741,Bingöl,Genç
50-54,786,722,1508,Bingöl,Genç
55-59,625,598,1223,Bingöl,Genç
60-64,538,624,1162,Bingöl,Genç
65-69,406,492,898,Bingöl,Genç
70-74,297,372,669,Bingöl,Genç
75+,515,697,1212,Bingöl,Genç
18-24,481,412,893,Ordu,Mesudiye
25-29,378,259,637,Ordu,Mesudiye
30-34,325,237,562,Ordu,Mesudiye
35-39,365,252,617,Ordu,Mesudiye
40-44,358,288,646,Ordu,Mesudiye
45-49,375,376,751,Ordu,Mesudiye
50-54,581,626,1207,Ordu,Mesudiye
55-59,774,726,1500,Ordu,Mesudiye
60-64,822,876,1698,Ordu,Mesudiye
65-69,715,703,1418,Ordu,Mesudiye
70-74,565,610,1175,Ordu,Mesudiye
75+,889,1123,2012,Ordu,Mesudiye
18-24,12812,12253,25065,Van,Erciş
25-29,7630,7063,14693,Van,Erciş
30-34,6026,5339,11365,Van,Erciş
35-39,5503,5172,10675,Van,Erciş
40-44,3989,3606,7595,Van,Erciş
45-49,3623,3547,7170,Van,Erciş
50-54,3143,2512,5655,Van,Erciş
55-59,2293,2304,4597,Van,Erciş
60-64,1725,1957,3682,Van,Erciş
65-69,1252,1441,2693,Van,Erciş
70-74,813,1077,1890,Van,Erciş
75+,1115,1400,2515,Van,Erciş
18-24,1142,1106,2248,Sakarya,Kocaali
25-29,673,644,1317,Sakarya,Kocaali
30-34,623,554,1177,Sakarya,Kocaali
35-39,688,640,1328,Sakarya,Kocaali
40-44,705,703,1408,Sakarya,Kocaali
45-49,765,724,1489,Sakarya,Kocaali
50-54,796,759,1555,Sakarya,Kocaali
55-59,799,735,1534,Sakarya,Kocaali
60-64,776,722,1498,Sakarya,Kocaali
65-69,599,583,1182,Sakarya,Kocaali
70-74,374,451,825,Sakarya,Kocaali
75+,436,668,1104,Sakarya,Kocaali
18-24,542,518,1060,Adıyaman,Samsat
25-29,332,239,571,Adıyaman,Samsat
30-34,237,209,446,Adıyaman,Samsat
35-39,232,230,462,Adıyaman,Samsat
40-44,205,197,402,Adıyaman,Samsat
45-49,188,187,375,Adıyaman,Samsat
50-54,172,159,331,Adıyaman,Samsat
55-59,144,144,288,Adıyaman,Samsat
60-64,132,147,279,Adıyaman,Samsat
65-69,91,118,209,Adıyaman,Samsat
70-74,74,116,190,Adıyaman,Samsat
75+,78,115,193,Adıyaman,Samsat
18-24,2114,984,3098,İzmir,Foça
25-29,2686,801,3487,İzmir,Foça
30-34,996,868,1864,İzmir,Foça
35-39,1015,959,1974,İzmir,Foça
40-44,923,850,1773,İzmir,Foça
45-49,830,853,1683,İzmir,Foça
50-54,837,942,1779,İzmir,Foça
55-59,1013,1041,2054,İzmir,Foça
60-64,992,996,1988,İzmir,Foça
65-69,894,850,1744,İzmir,Foça
70-74,642,587,1229,İzmir,Foça
75+,705,858,1563,İzmir,Foça
18-24,166,197,363,Bolu,Seben
25-29,115,91,206,Bolu,Seben
30-34,121,105,226,Bolu,Seben
35-39,115,120,235,Bolu,Seben
40-44,127,118,245,Bolu,Seben
45-49,140,132,272,Bolu,Seben
50-54,166,170,336,Bolu,Seben
55-59,209,200,409,Bolu,Seben
60-64,207,228,435,Bolu,Seben
65-69,211,253,464,Bolu,Seben
70-74,188,202,390,Bolu,Seben
75+,336,493,829,Bolu,Seben
18-24,63,73,136,Konya,Yalıhüyük
25-29,37,28,65,Konya,Yalıhüyük
30-34,26,24,50,Konya,Yalıhüyük
35-39,26,25,51,Konya,Yalıhüyük
40-44,22,24,46,Konya,Yalıhüyük
45-49,35,38,73,Konya,Yalıhüyük
50-54,59,65,124,Konya,Yalıhüyük
55-59,84,90,174,Konya,Yalıhüyük
60-64,78,83,161,Konya,Yalıhüyük
65-69,70,65,135,Konya,Yalıhüyük
70-74,71,73,144,Konya,Yalıhüyük
75+,67,113,180,Konya,Yalıhüyük
18-24,15335,15642,30977,İstanbul,Arnavutköy
25-29,11950,11501,23451,İstanbul,Arnavutköy
30-34,12133,11130,23263,İstanbul,Arnavutköy
35-39,12229,10834,23063,İstanbul,Arnavutköy
40-44,9478,7879,17357,İstanbul,Arnavutköy
45-49,7287,6469,13756,İstanbul,Arnavutköy
50-54,6057,5357,11414,İstanbul,Arnavutköy
55-59,4626,4266,8892,İstanbul,Arnavutköy
60-64,3450,3199,6649,İstanbul,Arnavutköy
65-69,2035,2216,4251,İstanbul,Arnavutköy
70-74,1201,1363,2564,İstanbul,Arnavutköy
75+,1312,2037,3349,İstanbul,Arnavutköy
18-24,27064,26865,53929,İstanbul,Üsküdar
25-29,21083,21116,42199,İstanbul,Üsküdar
30-34,21141,21464,42605,İstanbul,Üsküdar
35-39,22042,23344,45386,İstanbul,Üsküdar
40-44,20228,22236,42464,İstanbul,Üsküdar
45-49,18996,20338,39334,İstanbul,Üsküdar
50-54,16448,17572,34020,İstanbul,Üsküdar
55-59,14306,14978,29284,İstanbul,Üsküdar
60-64,11306,12274,23580,İstanbul,Üsküdar
65-69,8022,9259,17281,İstanbul,Üsküdar
70-74,5293,6632,11925,İstanbul,Üsküdar
75+,6972,11698,18670,İstanbul,Üsküdar
18-24,343,330,673,Elazığ,Sivrice
25-29,228,245,473,Elazığ,Sivrice
30-34,227,224,451,Elazığ,Sivrice
35-39,261,239,500,Elazığ,Sivrice
40-44,221,220,441,Elazığ,Sivrice
45-49,200,275,475,Elazığ,Sivrice
50-54,229,287,516,Elazığ,Sivrice
55-59,232,292,524,Elazığ,Sivrice
60-64,257,263,520,Elazığ,Sivrice
65-69,217,269,486,Elazığ,Sivrice
70-74,164,238,402,Elazığ,Sivrice
75+,382,427,809,Elazığ,Sivrice
18-24,519,449,968,Giresun,Alucra
25-29,276,214,490,Giresun,Alucra
30-34,216,202,418,Giresun,Alucra
35-39,226,194,420,Giresun,Alucra
40-44,229,172,401,Giresun,Alucra
45-49,239,219,458,Giresun,Alucra
50-54,308,240,548,Giresun,Alucra
55-59,300,323,623,Giresun,Alucra
60-64,305,366,671,Giresun,Alucra
65-69,339,341,680,Giresun,Alucra
70-74,254,293,547,Giresun,Alucra
75+,509,660,1169,Giresun,Alucra
18-24,1794,1741,3535,Aksaray,Eskil
25-29,956,879,1835,Aksaray,Eskil
30-34,913,880,1793,Aksaray,Eskil
35-39,931,948,1879,Aksaray,Eskil
40-44,870,855,1725,Aksaray,Eskil
45-49,801,775,1576,Aksaray,Eskil
50-54,722,666,1388,Aksaray,Eskil
55-59,478,478,956,Aksaray,Eskil
60-64,384,438,822,Aksaray,Eskil
65-69,329,385,714,Aksaray,Eskil
70-74,241,338,579,Aksaray,Eskil
75+,271,437,708,Aksaray,Eskil
18-24,8179,8546,16725,Kahramanmaraş,Elbistan
25-29,4601,5087,9688,Kahramanmaraş,Elbistan
30-34,5352,5388,10740,Kahramanmaraş,Elbistan
35-39,6000,5546,11546,Kahramanmaraş,Elbistan
40-44,4981,4589,9570,Kahramanmaraş,Elbistan
45-49,4475,4138,8613,Kahramanmaraş,Elbistan
50-54,3727,3428,7155,Kahramanmaraş,Elbistan
55-59,3152,2713,5865,Kahramanmaraş,Elbistan
60-64,2417,2274,4691,Kahramanmaraş,Elbistan
65-69,1988,1975,3963,Kahramanmaraş,Elbistan
70-74,1241,1570,2811,Kahramanmaraş,Elbistan
75+,1818,2539,4357,Kahramanmaraş,Elbistan
18-24,2468,2460,4928,Yozgat,Akdağmadeni
25-29,1395,1382,2777,Yozgat,Akdağmadeni
30-34,1345,1309,2654,Yozgat,Akdağmadeni
35-39,1312,1384,2696,Yozgat,Akdağmadeni
40-44,1212,1238,2450,Yozgat,Akdağmadeni
45-49,1164,1184,2348,Yozgat,Akdağmadeni
50-54,1128,1185,2313,Yozgat,Akdağmadeni
55-59,1056,1110,2166,Yozgat,Akdağmadeni
60-64,1020,1050,2070,Yozgat,Akdağmadeni
65-69,828,968,1796,Yozgat,Akdağmadeni
70-74,617,779,1396,Yozgat,Akdağmadeni
75+,907,1198,2105,Yozgat,Akdağmadeni
18-24,3659,3779,7438,Kayseri,Develi
25-29,2114,1977,4091,Kayseri,Develi
30-34,2244,2102,4346,Kayseri,Develi
35-39,2298,2197,4495,Kayseri,Develi
40-44,2083,1977,4060,Kayseri,Develi
45-49,2038,1899,3937,Kayseri,Develi
50-54,1953,1846,3799,Kayseri,Develi
55-59,1837,1691,3528,Kayseri,Develi
60-64,1437,1574,3011,Kayseri,Develi
65-69,1256,1365,2621,Kayseri,Develi
70-74,842,1126,1968,Kayseri,Develi
75+,1201,1836,3037,Kayseri,Develi
18-24,24878,25159,50037,Elazığ,Elazığ Merkez
25-29,14769,15753,30522,Elazığ,Elazığ Merkez
30-34,15235,16567,31802,Elazığ,Elazığ Merkez
35-39,16289,17729,34018,Elazığ,Elazığ Merkez
40-44,14525,15966,30491,Elazığ,Elazığ Merkez
45-49,13188,14191,27379,Elazığ,Elazığ Merkez
50-54,12125,12923,25048,Elazığ,Elazığ Merkez
55-59,10520,11243,21763,Elazığ,Elazığ Merkez
60-64,8923,9297,18220,Elazığ,Elazığ Merkez
65-69,6160,6712,12872,Elazığ,Elazığ Merkez
70-74,4010,4919,8929,Elazığ,Elazığ Merkez
75+,5895,8378,14273,Elazığ,Elazığ Merkez
18-24,1681,1765,3446,Kastamonu,Tosya
25-29,1112,1120,2232,Kastamonu,Tosya
30-34,1209,1265,2474,Kastamonu,Tosya
35-39,1345,1314,2659,Kastamonu,Tosya
40-44,1256,1282,2538,Kastamonu,Tosya
45-49,1190,1224,2414,Kastamonu,Tosya
50-54,1246,1359,2605,Kastamonu,Tosya
55-59,1423,1481,2904,Kastamonu,Tosya
60-64,1292,1554,2846,Kastamonu,Tosya
65-69,1386,1506,2892,Kastamonu,Tosya
70-74,926,1087,2013,Kastamonu,Tosya
75+,1420,2070,3490,Kastamonu,Tosya
18-24,1426,1366,2792,Adıyaman,Sincik
25-29,736,701,1437,Adıyaman,Sincik
30-34,492,488,980,Adıyaman,Sincik
35-39,435,518,953,Adıyaman,Sincik
40-44,382,432,814,Adıyaman,Sincik
45-49,401,391,792,Adıyaman,Sincik
50-54,342,341,683,Adıyaman,Sincik
55-59,305,343,648,Adıyaman,Sincik
60-64,310,358,668,Adıyaman,Sincik
65-69,254,315,569,Adıyaman,Sincik
70-74,208,252,460,Adıyaman,Sincik
75+,331,385,716,Adıyaman,Sincik
18-24,2099,2131,4230,Kocaeli,Kandıra
25-29,1610,1366,2976,Kocaeli,Kandıra
30-34,1483,1268,2751,Kocaeli,Kandıra
35-39,1564,1282,2846,Kocaeli,Kandıra
40-44,1414,1227,2641,Kocaeli,Kandıra
45-49,1499,1465,2964,Kocaeli,Kandıra
50-54,1583,1583,3166,Kocaeli,Kandıra
55-59,1670,1718,3388,Kocaeli,Kandıra
60-64,1510,1449,2959,Kocaeli,Kandıra
65-69,1154,1272,2426,Kocaeli,Kandıra
70-74,882,986,1868,Kocaeli,Kandıra
75+,1587,1744,3331,Kocaeli,Kandıra
18-24,1053,1016,2069,Giresun,Keşap
25-29,566,515,1081,Giresun,Keşap
30-34,555,490,1045,Giresun,Keşap
35-39,560,530,1090,Giresun,Keşap
40-44,551,482,1033,Giresun,Keşap
45-49,545,603,1148,Giresun,Keşap
50-54,768,729,1497,Giresun,Keşap
55-59,848,839,1687,Giresun,Keşap
60-64,861,888,1749,Giresun,Keşap
65-69,639,708,1347,Giresun,Keşap
70-74,453,603,1056,Giresun,Keşap
75+,849,1372,2221,Giresun,Keşap
18-24,827,779,1606,Denizli,Çal
25-29,525,407,932,Denizli,Çal
30-34,515,490,1005,Denizli,Çal
35-39,585,471,1056,Denizli,Çal
40-44,583,573,1156,Denizli,Çal
45-49,651,624,1275,Denizli,Çal
50-54,672,706,1378,Denizli,Çal
55-59,765,707,1472,Denizli,Çal
60-64,588,587,1175,Denizli,Çal
65-69,541,751,1292,Denizli,Çal
70-74,451,694,1145,Denizli,Çal
75+,878,1358,2236,Denizli,Çal
18-24,15165,16024,31189,Afyonkarahisar,Afyonkarahisar Merkez
25-29,10418,11030,21448,Afyonkarahisar,Afyonkarahisar Merkez
30-34,11056,11840,22896,Afyonkarahisar,Afyonkarahisar Merkez
35-39,11720,12180,23900,Afyonkarahisar,Afyonkarahisar Merkez
40-44,9635,10095,19730,Afyonkarahisar,Afyonkarahisar Merkez
45-49,8701,8824,17525,Afyonkarahisar,Afyonkarahisar Merkez
50-54,7651,7187,14838,Afyonkarahisar,Afyonkarahisar Merkez
55-59,6568,6794,13362,Afyonkarahisar,Afyonkarahisar Merkez
60-64,5357,5361,10718,Afyonkarahisar,Afyonkarahisar Merkez
65-69,3760,3958,7718,Afyonkarahisar,Afyonkarahisar Merkez
70-74,2226,2558,4784,Afyonkarahisar,Afyonkarahisar Merkez
75+,2887,4136,7023,Afyonkarahisar,Afyonkarahisar Merkez
18-24,744,776,1520,Giresun,Yağlıdere
25-29,418,357,775,Giresun,Yağlıdere
30-34,403,364,767,Giresun,Yağlıdere
35-39,441,410,851,Giresun,Yağlıdere
40-44,426,390,816,Giresun,Yağlıdere
45-49,503,442,945,Giresun,Yağlıdere
50-54,542,503,1045,Giresun,Yağlıdere
55-59,515,496,1011,Giresun,Yağlıdere
60-64,595,619,1214,Giresun,Yağlıdere
65-69,467,525,992,Giresun,Yağlıdere
70-74,286,388,674,Giresun,Yağlıdere
75+,565,861,1426,Giresun,Yağlıdere
18-24,3246,3572,6818,Erzurum,Aziziye
25-29,2118,2254,4372,Erzurum,Aziziye
30-34,2218,2286,4504,Erzurum,Aziziye
35-39,2121,2128,4249,Erzurum,Aziziye
40-44,1874,1796,3670,Erzurum,Aziziye
45-49,1601,1498,3099,Erzurum,Aziziye
50-54,1370,1412,2782,Erzurum,Aziziye
55-59,1123,1223,2346,Erzurum,Aziziye
60-64,993,1112,2105,Erzurum,Aziziye
65-69,759,802,1561,Erzurum,Aziziye
70-74,553,660,1213,Erzurum,Aziziye
75+,653,897,1550,Erzurum,Aziziye
18-24,1613,1788,3401,Erzurum,Oltu
25-29,1115,1120,2235,Erzurum,Oltu
30-34,1123,1031,2154,Erzurum,Oltu
35-39,1025,989,2014,Erzurum,Oltu
40-44,1005,910,1915,Erzurum,Oltu
45-49,891,863,1754,Erzurum,Oltu
50-54,871,933,1804,Erzurum,Oltu
55-59,737,869,1606,Erzurum,Oltu
60-64,698,745,1443,Erzurum,Oltu
65-69,568,684,1252,Erzurum,Oltu
70-74,462,553,1015,Erzurum,Oltu
75+,867,935,1802,Erzurum,Oltu
18-24,3556,3705,7261,Van,Başkale
25-29,2341,2064,4405,Van,Başkale
30-34,1518,1414,2932,Van,Başkale
35-39,1603,1721,3324,Van,Başkale
40-44,1160,1047,2207,Van,Başkale
45-49,977,736,1713,Van,Başkale
50-54,940,820,1760,Van,Başkale
55-59,673,618,1291,Van,Başkale
60-64,488,535,1023,Van,Başkale
65-69,317,407,724,Van,Başkale
70-74,203,282,485,Van,Başkale
75+,240,384,624,Van,Başkale
18-24,3311,3030,6341,Şırnak,Uludere
25-29,2578,1625,4203,Şırnak,Uludere
30-34,1239,983,2222,Şırnak,Uludere
35-39,1445,1202,2647,Şırnak,Uludere
40-44,918,940,1858,Şırnak,Uludere
45-49,692,656,1348,Şırnak,Uludere
50-54,601,628,1229,Şırnak,Uludere
55-59,434,411,845,Şırnak,Uludere
60-64,269,449,718,Şırnak,Uludere
65-69,281,334,615,Şırnak,Uludere
70-74,207,230,437,Şırnak,Uludere
75+,217,477,694,Şırnak,Uludere
18-24,1566,1619,3185,Van,Çatak
25-29,909,732,1641,Van,Çatak
30-34,612,506,1118,Van,Çatak
35-39,626,619,1245,Van,Çatak
40-44,442,383,825,Van,Çatak
45-49,478,351,829,Van,Çatak
50-54,487,324,811,Van,Çatak
55-59,326,282,608,Van,Çatak
60-64,203,258,461,Van,Çatak
65-69,152,206,358,Van,Çatak
70-74,116,169,285,Van,Çatak
75+,114,182,296,Van,Çatak
18-24,4639,4657,9296,Siirt,Kurtalan
25-29,2596,2464,5060,Siirt,Kurtalan
30-34,1992,1767,3759,Siirt,Kurtalan
35-39,1742,1680,3422,Siirt,Kurtalan
40-44,1381,1361,2742,Siirt,Kurtalan
45-49,1129,1040,2169,Siirt,Kurtalan
50-54,1020,972,1992,Siirt,Kurtalan
55-59,820,838,1658,Siirt,Kurtalan
60-64,692,666,1358,Siirt,Kurtalan
65-69,401,573,974,Siirt,Kurtalan
70-74,281,374,655,Siirt,Kurtalan
75+,458,680,1138,Siirt,Kurtalan
18-24,17896,19497,37393,Konya,Karatay
25-29,12209,12284,24493,Konya,Karatay
30-34,12960,12568,25528,Konya,Karatay
35-39,12310,11928,24238,Konya,Karatay
40-44,10085,9954,20039,Konya,Karatay
45-49,8951,8951,17902,Konya,Karatay
50-54,7713,7653,15366,Konya,Karatay
55-59,6181,6457,12638,Konya,Karatay
60-64,4734,5079,9813,Konya,Karatay
65-69,3562,4176,7738,Konya,Karatay
70-74,2192,2867,5059,Konya,Karatay
75+,2687,3947,6634,Konya,Karatay
18-24,9001,8702,17703,Adıyaman,Kahta
25-29,5064,4596,9660,Adıyaman,Kahta
30-34,4506,4085,8591,Adıyaman,Kahta
35-39,3918,3903,7821,Adıyaman,Kahta
40-44,3187,3221,6408,Adıyaman,Kahta
45-49,2704,2763,5467,Adıyaman,Kahta
50-54,2416,2065,4481,Adıyaman,Kahta
55-59,1805,1901,3706,Adıyaman,Kahta
60-64,1533,1696,3229,Adıyaman,Kahta
65-69,1266,1472,2738,Adıyaman,Kahta
70-74,838,1137,1975,Adıyaman,Kahta
75+,1399,1783,3182,Adıyaman,Kahta
18-24,125,111,236,Kırklareli,Pehlivanköy
25-29,104,75,179,Kırklareli,Pehlivanköy
30-34,79,67,146,Kırklareli,Pehlivanköy
35-39,100,75,175,Kırklareli,Pehlivanköy
40-44,83,85,168,Kırklareli,Pehlivanköy
45-49,131,120,251,Kırklareli,Pehlivanköy
50-54,154,136,290,Kırklareli,Pehlivanköy
55-59,200,179,379,Kırklareli,Pehlivanköy
60-64,172,190,362,Kırklareli,Pehlivanköy
65-69,162,145,307,Kırklareli,Pehlivanköy
70-74,96,131,227,Kırklareli,Pehlivanköy
75+,194,275,469,Kırklareli,Pehlivanköy
18-24,22419,24028,46447,Kahramanmaraş,Onikişubat
25-29,13903,15523,29426,Kahramanmaraş,Onikişubat
30-34,15420,16661,32081,Kahramanmaraş,Onikişubat
35-39,16955,16763,33718,Kahramanmaraş,Onikişubat
40-44,14157,13337,27494,Kahramanmaraş,Onikişubat
45-49,11702,11239,22941,Kahramanmaraş,Onikişubat
50-54,9571,8977,18548,Kahramanmaraş,Onikişubat
55-59,8301,7580,15881,Kahramanmaraş,Onikişubat
60-64,6581,6032,12613,Kahramanmaraş,Onikişubat
65-69,4475,4483,8958,Kahramanmaraş,Onikişubat
70-74,3067,3024,6091,Kahramanmaraş,Onikişubat
75+,3760,4726,8486,Kahramanmaraş,Onikişubat
18-24,16011,16775,32786,Samsun,İlkadım
25-29,10775,11456,22231,Samsun,İlkadım
30-34,11794,12042,23836,Samsun,İlkadım
35-39,13131,14035,27166,Samsun,İlkadım
40-44,12149,12675,24824,Samsun,İlkadım
45-49,10887,11656,22543,Samsun,İlkadım
50-54,10315,11243,21558,Samsun,İlkadım
55-59,9102,9799,18901,Samsun,İlkadım
60-64,7568,8042,15610,Samsun,İlkadım
65-69,5386,6183,11569,Samsun,İlkadım
70-74,3447,4363,7810,Samsun,İlkadım
75+,4417,7395,11812,Samsun,İlkadım
18-24,221,199,420,Burdur,Çeltikçi
25-29,125,113,238,Burdur,Çeltikçi
30-34,109,79,188,Burdur,Çeltikçi
35-39,116,143,259,Burdur,Çeltikçi
40-44,140,141,281,Burdur,Çeltikçi
45-49,173,179,352,Burdur,Çeltikçi
50-54,203,184,387,Burdur,Çeltikçi
55-59,215,252,467,Burdur,Çeltikçi
60-64,190,236,426,Burdur,Çeltikçi
65-69,181,229,410,Burdur,Çeltikçi
70-74,150,211,361,Burdur,Çeltikçi
75+,225,369,594,Burdur,Çeltikçi
18-24,17088,17707,34795,Denizli,Pamukkale
25-29,12736,12649,25385,Denizli,Pamukkale
30-34,13533,13486,27019,Denizli,Pamukkale
35-39,14869,15206,30075,Denizli,Pamukkale
40-44,13347,13330,26677,Denizli,Pamukkale
45-49,11781,11404,23185,Denizli,Pamukkale
50-54,10280,9897,20177,Denizli,Pamukkale
55-59,8347,8471,16818,Denizli,Pamukkale
60-64,6432,6724,13156,Denizli,Pamukkale
65-69,4699,4924,9623,Denizli,Pamukkale
70-74,2888,3491,6379,Denizli,Pamukkale
75+,3476,4788,8264,Denizli,Pamukkale
18-24,1435,1350,2785,Malatya,Akçadağ
25-29,848,698,1546,Malatya,Akçadağ
30-34,899,645,1544,Malatya,Akçadağ
35-39,895,743,1638,Malatya,Akçadağ
40-44,865,709,1574,Malatya,Akçadağ
45-49,898,808,1706,Malatya,Akçadağ
50-54,936,847,1783,Malatya,Akçadağ
55-59,879,860,1739,Malatya,Akçadağ
60-64,842,836,1678,Malatya,Akçadağ
65-69,746,783,1529,Malatya,Akçadağ
70-74,556,689,1245,Malatya,Akçadağ
75+,821,1216,2037,Malatya,Akçadağ
18-24,1473,1475,2948,Rize,Pazar
25-29,901,896,1797,Rize,Pazar
30-34,959,917,1876,Rize,Pazar
35-39,962,904,1866,Rize,Pazar
40-44,1076,1013,2089,Rize,Pazar
45-49,1176,1187,2363,Rize,Pazar
50-54,1202,1206,2408,Rize,Pazar
55-59,1167,1136,2303,Rize,Pazar
60-64,977,1090,2067,Rize,Pazar
65-69,776,804,1580,Rize,Pazar
70-74,523,727,1250,Rize,Pazar
75+,762,1344,2106,Rize,Pazar
18-24,8062,8361,16423,Konya,Ereğli
25-29,4543,4475,9018,Konya,Ereğli
30-34,4751,4808,9559,Konya,Ereğli
35-39,5101,5229,10330,Konya,Ereğli
40-44,4737,4942,9679,Konya,Ereğli
45-49,4709,4934,9643,Konya,Ereğli
50-54,4392,4661,9053,Konya,Ereğli
55-59,3899,4018,7917,Konya,Ereğli
60-64,3327,3549,6876,Konya,Ereğli
65-69,2451,2819,5270,Konya,Ereğli
70-74,1666,2064,3730,Konya,Ereğli
75+,2134,3073,5207,Konya,Ereğli
18-24,4169,4269,8438,İzmir,Menderes
25-29,3375,3344,6719,İzmir,Menderes
30-34,3566,3404,6970,İzmir,Menderes
35-39,3816,3598,7414,İzmir,Menderes
40-44,3356,3161,6517,İzmir,Menderes
45-49,3050,3056,6106,İzmir,Menderes
50-54,3158,3089,6247,İzmir,Menderes
55-59,3038,2830,5868,İzmir,Menderes
60-64,2481,2604,5085,İzmir,Menderes
65-69,1851,2029,3880,İzmir,Menderes
70-74,1317,1331,2648,İzmir,Menderes
75+,1509,1934,3443,İzmir,Menderes
18-24,114,114,228,Bolu,Kıbrıscık
25-29,84,76,160,Bolu,Kıbrıscık
30-34,79,46,125,Bolu,Kıbrıscık
35-39,75,68,143,Bolu,Kıbrıscık
40-44,87,88,175,Bolu,Kıbrıscık
45-49,101,81,182,Bolu,Kıbrıscık
50-54,98,97,195,Bolu,Kıbrıscık
55-59,112,111,223,Bolu,Kıbrıscık
60-64,120,127,247,Bolu,Kıbrıscık
65-69,99,127,226,Bolu,Kıbrıscık
70-74,86,146,232,Bolu,Kıbrıscık
75+,190,260,450,Bolu,Kıbrıscık
18-24,401,508,909,Afyonkarahisar,Hocalar
25-29,281,225,506,Afyonkarahisar,Hocalar
30-34,298,255,553,Afyonkarahisar,Hocalar
35-39,293,282,575,Afyonkarahisar,Hocalar
40-44,309,319,628,Afyonkarahisar,Hocalar
45-49,311,329,640,Afyonkarahisar,Hocalar
50-54,341,337,678,Afyonkarahisar,Hocalar
55-59,330,327,657,Afyonkarahisar,Hocalar
60-64,232,325,557,Afyonkarahisar,Hocalar
65-69,258,283,541,Afyonkarahisar,Hocalar
70-74,182,208,390,Afyonkarahisar,Hocalar
75+,321,402,723,Afyonkarahisar,Hocalar
18-24,466,408,874,Edirne,Meriç
25-29,291,269,560,Edirne,Meriç
30-34,311,252,563,Edirne,Meriç
35-39,322,312,634,Edirne,Meriç
40-44,391,289,680,Edirne,Meriç
45-49,446,442,888,Edirne,Meriç
50-54,639,611,1250,Edirne,Meriç
55-59,751,714,1465,Edirne,Meriç
60-64,680,658,1338,Edirne,Meriç
65-69,644,618,1262,Edirne,Meriç
70-74,328,419,747,Edirne,Meriç
75+,630,897,1527,Edirne,Meriç
18-24,277,227,504,Konya,Ahırlı
25-29,122,118,240,Konya,Ahırlı
30-34,105,86,191,Konya,Ahırlı
35-39,110,100,210,Konya,Ahırlı
40-44,130,125,255,Konya,Ahırlı
45-49,108,130,238,Konya,Ahırlı
50-54,143,159,302,Konya,Ahırlı
55-59,165,171,336,Konya,Ahırlı
60-64,145,175,320,Konya,Ahırlı
65-69,126,133,259,Konya,Ahırlı
70-74,108,154,262,Konya,Ahırlı
75+,182,293,475,Konya,Ahırlı
18-24,1503,1513,3016,Denizli,Honaz
25-29,1076,936,2012,Denizli,Honaz
30-34,1103,951,2054,Denizli,Honaz
35-39,1187,1120,2307,Denizli,Honaz
40-44,1129,1011,2140,Denizli,Honaz
45-49,1083,925,2008,Denizli,Honaz
50-54,945,931,1876,Denizli,Honaz
55-59,883,826,1709,Denizli,Honaz
60-64,683,661,1344,Denizli,Honaz
65-69,479,554,1033,Denizli,Honaz
70-74,315,377,692,Denizli,Honaz
75+,413,657,1070,Denizli,Honaz
18-24,289,283,572,Eskişehir,Günyüzü
25-29,140,144,284,Eskişehir,Günyüzü
30-34,129,113,242,Eskişehir,Günyüzü
35-39,140,150,290,Eskişehir,Günyüzü
40-44,153,156,309,Eskişehir,Günyüzü
45-49,212,194,406,Eskişehir,Günyüzü
50-54,248,250,498,Eskişehir,Günyüzü
55-59,256,234,490,Eskişehir,Günyüzü
60-64,228,252,480,Eskişehir,Günyüzü
65-69,205,210,415,Eskişehir,Günyüzü
70-74,143,187,330,Eskişehir,Günyüzü
75+,259,350,609,Eskişehir,Günyüzü
18-24,566,667,1233,Kütahya,Hisarcık
25-29,361,351,712,Kütahya,Hisarcık
30-34,393,339,732,Kütahya,Hisarcık
35-39,451,456,907,Kütahya,Hisarcık
40-44,425,415,840,Kütahya,Hisarcık
45-49,437,467,904,Kütahya,Hisarcık
50-54,450,456,906,Kütahya,Hisarcık
55-59,406,461,867,Kütahya,Hisarcık
60-64,388,415,803,Kütahya,Hisarcık
65-69,283,369,652,Kütahya,Hisarcık
70-74,199,304,503,Kütahya,Hisarcık
75+,329,420,749,Kütahya,Hisarcık
18-24,8984,9048,18032,İzmir,Çiğli
25-29,7302,7395,14697,İzmir,Çiğli
30-34,8165,8208,16373,İzmir,Çiğli
35-39,9255,9082,18337,İzmir,Çiğli
40-44,8125,7998,16123,İzmir,Çiğli
45-49,6982,7072,14054,İzmir,Çiğli
50-54,6198,6362,12560,İzmir,Çiğli
55-59,5472,5520,10992,İzmir,Çiğli
60-64,4407,4707,9114,İzmir,Çiğli
65-69,3178,3369,6547,İzmir,Çiğli
70-74,1856,2176,4032,İzmir,Çiğli
75+,1876,2861,4737,İzmir,Çiğli
18-24,14092,13976,28068,İstanbul,Bayrampaşa
25-29,10790,10349,21139,İstanbul,Bayrampaşa
30-34,11086,11181,22267,İstanbul,Bayrampaşa
35-39,12115,11883,23998,İstanbul,Bayrampaşa
40-44,11009,11043,22052,İstanbul,Bayrampaşa
45-49,10240,9721,19961,İstanbul,Bayrampaşa
50-54,8695,8495,17190,İstanbul,Bayrampaşa
55-59,7240,6899,14139,İstanbul,Bayrampaşa
60-64,5582,5638,11220,İstanbul,Bayrampaşa
65-69,3649,3851,7500,İstanbul,Bayrampaşa
70-74,2096,2733,4829,İstanbul,Bayrampaşa
75+,2716,4269,6985,İstanbul,Bayrampaşa
18-24,1835,1877,3712,Antalya,Elmalı
25-29,1149,1073,2222,Antalya,Elmalı
30-34,1183,1147,2330,Antalya,Elmalı
35-39,1350,1296,2646,Antalya,Elmalı
40-44,1307,1292,2599,Antalya,Elmalı
45-49,1311,1312,2623,Antalya,Elmalı
50-54,1330,1335,2665,Antalya,Elmalı
55-59,1269,1298,2567,Antalya,Elmalı
60-64,1065,1093,2158,Antalya,Elmalı
65-69,969,1046,2015,Antalya,Elmalı
70-74,698,822,1520,Antalya,Elmalı
75+,1108,1471,2579,Antalya,Elmalı
18-24,5865,5761,11626,İzmir,Ödemiş
25-29,3912,3922,7834,İzmir,Ödemiş
30-34,4475,4365,8840,İzmir,Ödemiş
35-39,4877,5062,9939,İzmir,Ödemiş
40-44,4587,4734,9321,İzmir,Ödemiş
45-49,4426,4567,8993,İzmir,Ödemiş
50-54,4574,4549,9123,İzmir,Ödemiş
55-59,4647,4894,9541,İzmir,Ödemiş
60-64,4161,4197,8358,İzmir,Ödemiş
65-69,3100,3344,6444,İzmir,Ödemiş
70-74,2206,2719,4925,İzmir,Ödemiş
75+,3067,5090,8157,İzmir,Ödemiş
18-24,1377,1335,2712,Kayseri,İncesu
25-29,896,829,1725,Kayseri,İncesu
30-34,989,857,1846,Kayseri,İncesu
35-39,1063,962,2025,Kayseri,İncesu
40-44,903,765,1668,Kayseri,İncesu
45-49,689,683,1372,Kayseri,İncesu
50-54,635,636,1271,Kayseri,İncesu
55-59,573,636,1209,Kayseri,İncesu
60-64,553,563,1116,Kayseri,İncesu
65-69,463,527,990,Kayseri,İncesu
70-74,352,448,800,Kayseri,İncesu
75+,547,747,1294,Kayseri,İncesu
18-24,2185,2237,4422,Tekirdağ,Malkara
25-29,1791,1581,3372,Tekirdağ,Malkara
30-34,1715,1505,3220,Tekirdağ,Malkara
35-39,1704,1576,3280,Tekirdağ,Malkara
40-44,1644,1589,3233,Tekirdağ,Malkara
45-49,1853,1793,3646,Tekirdağ,Malkara
50-54,1941,1945,3886,Tekirdağ,Malkara
55-59,2026,2132,4158,Tekirdağ,Malkara
60-64,1881,1836,3717,Tekirdağ,Malkara
65-69,1458,1594,3052,Tekirdağ,Malkara
70-74,957,1080,2037,Tekirdağ,Malkara
75+,1532,2067,3599,Tekirdağ,Malkara
18-24,411,392,803,Konya,Akören
25-29,167,126,293,Konya,Akören
30-34,157,126,283,Konya,Akören
35-39,165,150,315,Konya,Akören
40-44,170,163,333,Konya,Akören
45-49,175,165,340,Konya,Akören
50-54,164,168,332,Konya,Akören
55-59,147,172,319,Konya,Akören
60-64,143,172,315,Konya,Akören
65-69,116,157,273,Konya,Akören
70-74,76,111,187,Konya,Akören
75+,208,299,507,Konya,Akören
18-24,4402,4845,9247,Çankırı,Çankırı Merkez
25-29,3146,3185,6331,Çankırı,Çankırı Merkez
30-34,3234,3251,6485,Çankırı,Çankırı Merkez
35-39,3233,3330,6563,Çankırı,Çankırı Merkez
40-44,2970,2984,5954,Çankırı,Çankırı Merkez
45-49,2623,2773,5396,Çankırı,Çankırı Merkez
50-54,2587,2662,5249,Çankırı,Çankırı Merkez
55-59,2302,2310,4612,Çankırı,Çankırı Merkez
60-64,1892,2000,3892,Çankırı,Çankırı Merkez
65-69,1378,1552,2930,Çankırı,Çankırı Merkez
70-74,879,1121,2000,Çankırı,Çankırı Merkez
75+,1423,1905,3328,Çankırı,Çankırı Merkez
18-24,2035,2035,4070,Muğla,Yatağan
25-29,1487,1445,2932,Muğla,Yatağan
30-34,1661,1503,3164,Muğla,Yatağan
35-39,1744,1591,3335,Muğla,Yatağan
40-44,1539,1495,3034,Muğla,Yatağan
45-49,1590,1571,3161,Muğla,Yatağan
50-54,1596,1597,3193,Muğla,Yatağan
55-59,1581,1483,3064,Muğla,Yatağan
60-64,1352,1316,2668,Muğla,Yatağan
65-69,1012,1073,2085,Muğla,Yatağan
70-74,745,839,1584,Muğla,Yatağan
75+,1197,1848,3045,Muğla,Yatağan
18-24,2720,2615,5335,Kars,Sarıkamış
25-29,1795,1567,3362,Kars,Sarıkamış
30-34,1448,1261,2709,Kars,Sarıkamış
35-39,1382,1316,2698,Kars,Sarıkamış
40-44,1110,1002,2112,Kars,Sarıkamış
45-49,985,912,1897,Kars,Sarıkamış
50-54,964,893,1857,Kars,Sarıkamış
55-59,716,794,1510,Kars,Sarıkamış
60-64,694,652,1346,Kars,Sarıkamış
65-69,504,522,1026,Kars,Sarıkamış
70-74,424,496,920,Kars,Sarıkamış
75+,500,685,1185,Kars,Sarıkamış
18-24,1895,1822,3717,Diyarbakır,Eğil
25-29,994,877,1871,Diyarbakır,Eğil
30-34,687,672,1359,Diyarbakır,Eğil
35-39,558,654,1212,Diyarbakır,Eğil
40-44,473,559,1032,Diyarbakır,Eğil
45-49,417,457,874,Diyarbakır,Eğil
50-54,471,447,918,Diyarbakır,Eğil
55-59,377,362,739,Diyarbakır,Eğil
60-64,289,341,630,Diyarbakır,Eğil
65-69,252,287,539,Diyarbakır,Eğil
70-74,203,235,438,Diyarbakır,Eğil
75+,261,430,691,Diyarbakır,Eğil
18-24,1437,1472,2909,Sakarya,Pamukova
25-29,1013,1014,2027,Sakarya,Pamukova
30-34,1040,984,2024,Sakarya,Pamukova
35-39,1163,1127,2290,Sakarya,Pamukova
40-44,1081,1000,2081,Sakarya,Pamukova
45-49,951,905,1856,Sakarya,Pamukova
50-54,841,849,1690,Sakarya,Pamukova
55-59,851,928,1779,Sakarya,Pamukova
60-64,725,758,1483,Sakarya,Pamukova
65-69,571,608,1179,Sakarya,Pamukova
70-74,338,399,737,Sakarya,Pamukova
75+,529,779,1308,Sakarya,Pamukova
18-24,1726,1787,3513,Çanakkale,Gelibolu
25-29,1320,1244,2564,Çanakkale,Gelibolu
30-34,1342,1272,2614,Çanakkale,Gelibolu
35-39,1457,1519,2976,Çanakkale,Gelibolu
40-44,1469,1464,2933,Çanakkale,Gelibolu
45-49,1521,1438,2959,Çanakkale,Gelibolu
50-54,1533,1498,3031,Çanakkale,Gelibolu
55-59,1466,1529,2995,Çanakkale,Gelibolu
60-64,1393,1425,2818,Çanakkale,Gelibolu
65-69,1141,1208,2349,Çanakkale,Gelibolu
70-74,797,875,1672,Çanakkale,Gelibolu
75+,988,1496,2484,Çanakkale,Gelibolu
18-24,27017,28347,55364,Ankara,Etimesgut
25-29,22203,24520,46723,Ankara,Etimesgut
30-34,25779,26942,52721,Ankara,Etimesgut
35-39,26727,27363,54090,Ankara,Etimesgut
40-44,22821,22917,45738,Ankara,Etimesgut
45-49,19725,19791,39516,Ankara,Etimesgut
50-54,16643,16973,33616,Ankara,Etimesgut
55-59,13931,13574,27505,Ankara,Etimesgut
60-64,9752,9765,19517,Ankara,Etimesgut
65-69,6132,6262,12394,Ankara,Etimesgut
70-74,3286,3923,7209,Ankara,Etimesgut
75+,3332,5524,8856,Ankara,Etimesgut
18-24,2581,2662,5243,İzmir,Urla
25-29,1915,1790,3705,İzmir,Urla
30-34,1961,1806,3767,İzmir,Urla
35-39,2172,2274,4446,İzmir,Urla
40-44,2111,2365,4476,İzmir,Urla
45-49,2231,2361,4592,İzmir,Urla
50-54,2413,2517,4930,İzmir,Urla
55-59,2362,2360,4722,İzmir,Urla
60-64,2115,2051,4166,İzmir,Urla
65-69,1699,1814,3513,İzmir,Urla
70-74,1326,1306,2632,İzmir,Urla
75+,1729,1980,3709,İzmir,Urla
18-24,1454,1677,3131,Aksaray,Ortaköy
25-29,890,848,1738,Aksaray,Ortaköy
30-34,943,938,1881,Aksaray,Ortaköy
35-39,1022,1013,2035,Aksaray,Ortaköy
40-44,1016,989,2005,Aksaray,Ortaköy
45-49,905,952,1857,Aksaray,Ortaköy
50-54,1030,1100,2130,Aksaray,Ortaköy
55-59,855,1041,1896,Aksaray,Ortaköy
60-64,837,917,1754,Aksaray,Ortaköy
65-69,789,890,1679,Aksaray,Ortaköy
70-74,515,719,1234,Aksaray,Ortaköy
75+,660,942,1602,Aksaray,Ortaköy
18-24,1137,1068,2205,Sivas,Gemerek
25-29,675,573,1248,Sivas,Gemerek
30-34,696,604,1300,Sivas,Gemerek
35-39,718,646,1364,Sivas,Gemerek
40-44,699,687,1386,Sivas,Gemerek
45-49,675,665,1340,Sivas,Gemerek
50-54,693,717,1410,Sivas,Gemerek
55-59,767,853,1620,Sivas,Gemerek
60-64,688,770,1458,Sivas,Gemerek
65-69,651,685,1336,Sivas,Gemerek
70-74,492,602,1094,Sivas,Gemerek
75+,736,1040,1776,Sivas,Gemerek
18-24,1185,1259,2444,Elazığ,Palu
25-29,820,690,1510,Elazığ,Palu
30-34,761,658,1419,Elazığ,Palu
35-39,602,608,1210,Elazığ,Palu
40-44,543,579,1122,Elazığ,Palu
45-49,519,512,1031,Elazığ,Palu
50-54,513,472,985,Elazığ,Palu
55-59,452,447,899,Elazığ,Palu
60-64,341,424,765,Elazığ,Palu
65-69,255,250,505,Elazığ,Palu
70-74,207,242,449,Elazığ,Palu
75+,329,414,743,Elazığ,Palu
18-24,282,334,616,Elazığ,Keban
25-29,196,198,394,Elazığ,Keban
30-34,181,170,351,Elazığ,Keban
35-39,218,206,424,Elazığ,Keban
40-44,188,205,393,Elazığ,Keban
45-49,198,226,424,Elazığ,Keban
50-54,223,226,449,Elazığ,Keban
55-59,209,218,427,Elazığ,Keban
60-64,167,199,366,Elazığ,Keban
65-69,176,181,357,Elazığ,Keban
70-74,129,160,289,Elazığ,Keban
75+,230,318,548,Elazığ,Keban
18-24,808,819,1627,Samsun,Ladik
25-29,468,427,895,Samsun,Ladik
30-34,451,406,857,Samsun,Ladik
35-39,438,433,871,Samsun,Ladik
40-44,443,512,955,Samsun,Ladik
45-49,486,573,1059,Samsun,Ladik
50-54,564,600,1164,Samsun,Ladik
55-59,651,614,1265,Samsun,Ladik
60-64,544,597,1141,Samsun,Ladik
65-69,535,637,1172,Samsun,Ladik
70-74,432,461,893,Samsun,Ladik
75+,667,867,1534,Samsun,Ladik
18-24,199,212,411,Edirne,Süloğlu
25-29,250,179,429,Edirne,Süloğlu
30-34,171,130,301,Edirne,Süloğlu
35-39,207,158,365,Edirne,Süloğlu
40-44,205,143,348,Edirne,Süloğlu
45-49,188,174,362,Edirne,Süloğlu
50-54,200,189,389,Edirne,Süloğlu
55-59,238,271,509,Edirne,Süloğlu
60-64,276,252,528,Edirne,Süloğlu
65-69,251,248,499,Edirne,Süloğlu
70-74,134,145,279,Edirne,Süloğlu
75+,205,307,512,Edirne,Süloğlu
18-24,797,800,1597,Trabzon,Düzköy
25-29,486,408,894,Trabzon,Düzköy
30-34,437,404,841,Trabzon,Düzköy
35-39,497,432,929,Trabzon,Düzköy
40-44,466,443,909,Trabzon,Düzköy
45-49,428,383,811,Trabzon,Düzköy
50-54,474,493,967,Trabzon,Düzköy
55-59,418,450,868,Trabzon,Düzköy
60-64,405,493,898,Trabzon,Düzköy
65-69,287,336,623,Trabzon,Düzköy
70-74,184,316,500,Trabzon,Düzköy
75+,249,596,845,Trabzon,Düzköy
18-24,2154,2129,4283,Çorum,Osmancık
25-29,1230,1249,2479,Çorum,Osmancık
30-34,1341,1319,2660,Çorum,Osmancık
35-39,1466,1462,2928,Çorum,Osmancık
40-44,1338,1307,2645,Çorum,Osmancık
45-49,1258,1277,2535,Çorum,Osmancık
50-54,1376,1320,2696,Çorum,Osmancık
55-59,1418,1398,2816,Çorum,Osmancık
60-64,1233,1409,2642,Çorum,Osmancık
65-69,1132,1388,2520,Çorum,Osmancık
70-74,863,990,1853,Çorum,Osmancık
75+,1293,1785,3078,Çorum,Osmancık
18-24,256,224,480,Erzurum,Olur
25-29,183,154,337,Erzurum,Olur
30-34,173,135,308,Erzurum,Olur
35-39,181,165,346,Erzurum,Olur
40-44,170,147,317,Erzurum,Olur
45-49,188,206,394,Erzurum,Olur
50-54,177,200,377,Erzurum,Olur
55-59,255,287,542,Erzurum,Olur
60-64,239,272,511,Erzurum,Olur
65-69,237,311,548,Erzurum,Olur
70-74,225,276,501,Erzurum,Olur
75+,430,535,965,Erzurum,Olur
18-24,3800,3446,7246,Muğla,Marmaris
25-29,3410,2988,6398,Muğla,Marmaris
30-34,3946,3583,7529,Muğla,Marmaris
35-39,4666,4078,8744,Muğla,Marmaris
40-44,4397,3799,8196,Muğla,Marmaris
45-49,3747,3140,6887,Muğla,Marmaris
50-54,3282,2762,6044,Muğla,Marmaris
55-59,2669,2457,5126,Muğla,Marmaris
60-64,2075,1904,3979,Muğla,Marmaris
65-69,1560,1498,3058,Muğla,Marmaris
70-74,958,1027,1985,Muğla,Marmaris
75+,1450,1856,3306,Muğla,Marmaris
18-24,18110,18776,36886,Adana,Çukurova
25-29,11181,12571,23752,Adana,Çukurova
30-34,11874,14461,26335,Adana,Çukurova
35-39,13869,17016,30885,Adana,Çukurova
40-44,13816,16384,30200,Adana,Çukurova
45-49,12856,14221,27077,Adana,Çukurova
50-54,11749,12808,24557,Adana,Çukurova
55-59,10786,11193,21979,Adana,Çukurova
60-64,8985,9069,18054,Adana,Çukurova
65-69,6381,6441,12822,Adana,Çukurova
70-74,3551,3746,7297,Adana,Çukurova
75+,2834,4110,6944,Adana,Çukurova
18-24,3915,3988,7903,Bursa,Mudanya
25-29,2821,3078,5899,Bursa,Mudanya
30-34,2924,2909,5833,Bursa,Mudanya
35-39,3334,3567,6901,Bursa,Mudanya
40-44,3143,3327,6470,Bursa,Mudanya
45-49,2977,3457,6434,Bursa,Mudanya
50-54,3162,3553,6715,Bursa,Mudanya
55-59,3141,3564,6705,Bursa,Mudanya
60-64,3031,3278,6309,Bursa,Mudanya
65-69,2530,2551,5081,Bursa,Mudanya
70-74,1668,1784,3452,Bursa,Mudanya
75+,1963,2461,4424,Bursa,Mudanya
18-24,375,353,728,Isparta,Gönen
25-29,204,180,384,Isparta,Gönen
30-34,221,197,418,Isparta,Gönen
35-39,227,201,428,Isparta,Gönen
40-44,227,199,426,Isparta,Gönen
45-49,217,242,459,Isparta,Gönen
50-54,233,246,479,Isparta,Gönen
55-59,294,283,577,Isparta,Gönen
60-64,250,271,521,Isparta,Gönen
65-69,213,237,450,Isparta,Gönen
70-74,120,151,271,Isparta,Gönen
75+,241,359,600,Isparta,Gönen
18-24,1348,1269,2617,Gaziantep,Yavuzeli
25-29,792,671,1463,Gaziantep,Yavuzeli
30-34,715,635,1350,Gaziantep,Yavuzeli
35-39,657,616,1273,Gaziantep,Yavuzeli
40-44,526,487,1013,Gaziantep,Yavuzeli
45-49,427,468,895,Gaziantep,Yavuzeli
50-54,435,478,913,Gaziantep,Yavuzeli
55-59,421,371,792,Gaziantep,Yavuzeli
60-64,337,364,701,Gaziantep,Yavuzeli
65-69,258,347,605,Gaziantep,Yavuzeli
70-74,227,257,484,Gaziantep,Yavuzeli
75+,278,456,734,Gaziantep,Yavuzeli
18-24,1083,1074,2157,Ankara,Kızılcahamam
25-29,799,710,1509,Ankara,Kızılcahamam
30-34,741,638,1379,Ankara,Kızılcahamam
35-39,831,750,1581,Ankara,Kızılcahamam
40-44,736,702,1438,Ankara,Kızılcahamam
45-49,845,806,1651,Ankara,Kızılcahamam
50-54,860,889,1749,Ankara,Kızılcahamam
55-59,985,937,1922,Ankara,Kızılcahamam
60-64,913,907,1820,Ankara,Kızılcahamam
65-69,767,945,1712,Ankara,Kızılcahamam
70-74,601,724,1325,Ankara,Kızılcahamam
75+,982,1450,2432,Ankara,Kızılcahamam
18-24,14242,14873,29115,Aydın,Efeler
25-29,9797,10171,19968,Aydın,Efeler
30-34,9974,10523,20497,Aydın,Efeler
35-39,10941,11657,22598,Aydın,Efeler
40-44,10066,10811,20877,Aydın,Efeler
45-49,9385,9616,19001,Aydın,Efeler
50-54,8843,8847,17690,Aydın,Efeler
55-59,8357,8501,16858,Aydın,Efeler
60-64,7103,7235,14338,Aydın,Efeler
65-69,4931,5268,10199,Aydın,Efeler
70-74,3357,3905,7262,Aydın,Efeler
75+,4262,6463,10725,Aydın,Efeler
18-24,398,441,839,Samsun,Yakakent
25-29,220,213,433,Samsun,Yakakent
30-34,225,246,471,Samsun,Yakakent
35-39,256,275,531,Samsun,Yakakent
40-44,239,234,473,Samsun,Yakakent
45-49,252,263,515,Samsun,Yakakent
50-54,279,307,586,Samsun,Yakakent
55-59,290,307,597,Samsun,Yakakent
60-64,351,325,676,Samsun,Yakakent
65-69,243,298,541,Samsun,Yakakent
70-74,184,197,381,Samsun,Yakakent
75+,273,363,636,Samsun,Yakakent
18-24,328,349,677,Karabük,Eflani
25-29,198,181,379,Karabük,Eflani
30-34,185,157,342,Karabük,Eflani
35-39,207,179,386,Karabük,Eflani
40-44,202,204,406,Karabük,Eflani
45-49,206,234,440,Karabük,Eflani
50-54,255,287,542,Karabük,Eflani
55-59,340,348,688,Karabük,Eflani
60-64,379,402,781,Karabük,Eflani
65-69,360,373,733,Karabük,Eflani
70-74,256,316,572,Karabük,Eflani
75+,408,613,1021,Karabük,Eflani
18-24,944,931,1875,Kars,Arpaçay
25-29,642,498,1140,Kars,Arpaçay
30-34,517,472,989,Kars,Arpaçay
35-39,601,530,1131,Kars,Arpaçay
40-44,561,447,1008,Kars,Arpaçay
45-49,515,535,1050,Kars,Arpaçay
50-54,513,457,970,Kars,Arpaçay
55-59,477,443,920,Kars,Arpaçay
60-64,403,402,805,Kars,Arpaçay
65-69,329,374,703,Kars,Arpaçay
70-74,272,327,599,Kars,Arpaçay
75+,400,573,973,Kars,Arpaçay
18-24,18110,18603,36713,Malatya,Battalgazi
25-29,10955,11159,22114,Malatya,Battalgazi
30-34,10809,11077,21886,Malatya,Battalgazi
35-39,11356,11911,23267,Malatya,Battalgazi
40-44,10010,10492,20502,Malatya,Battalgazi
45-49,8834,9520,18354,Malatya,Battalgazi
50-54,8289,8448,16737,Malatya,Battalgazi
55-59,7015,7158,14173,Malatya,Battalgazi
60-64,5656,5683,11339,Malatya,Battalgazi
65-69,4186,4529,8715,Malatya,Battalgazi
70-74,2712,3400,6112,Malatya,Battalgazi
75+,3824,5444,9268,Malatya,Battalgazi
18-24,7155,7875,15030,Nevşehir,Nevşehir Merkez
25-29,4720,4958,9678,Nevşehir,Nevşehir Merkez
30-34,5288,5540,10828,Nevşehir,Nevşehir Merkez
35-39,5429,5550,10979,Nevşehir,Nevşehir Merkez
40-44,4851,4759,9610,Nevşehir,Nevşehir Merkez
45-49,4322,4245,8567,Nevşehir,Nevşehir Merkez
50-54,3912,3914,7826,Nevşehir,Nevşehir Merkez
55-59,3083,3245,6328,Nevşehir,Nevşehir Merkez
60-64,2487,2524,5011,Nevşehir,Nevşehir Merkez
65-69,1953,2023,3976,Nevşehir,Nevşehir Merkez
70-74,1213,1580,2793,Nevşehir,Nevşehir Merkez
75+,1543,2233,3776,Nevşehir,Nevşehir Merkez
18-24,19146,19074,38220,İstanbul,Eyüpsultan
25-29,14524,15083,29607,İstanbul,Eyüpsultan
30-34,16356,16440,32796,İstanbul,Eyüpsultan
35-39,17717,17772,35489,İstanbul,Eyüpsultan
40-44,16065,15640,31705,İstanbul,Eyüpsultan
45-49,13950,13678,27628,İstanbul,Eyüpsultan
50-54,11746,11194,22940,İstanbul,Eyüpsultan
55-59,9209,9011,18220,İstanbul,Eyüpsultan
60-64,6804,6988,13792,İstanbul,Eyüpsultan
65-69,4529,4966,9495,İstanbul,Eyüpsultan
70-74,2642,3267,5909,İstanbul,Eyüpsultan
75+,2997,5065,8062,İstanbul,Eyüpsultan
18-24,36105,37403,73508,Konya,Selçuklu
25-29,23457,24681,48138,Konya,Selçuklu
30-34,24906,26149,51055,Konya,Selçuklu
35-39,25220,26255,51475,Konya,Selçuklu
40-44,21609,22251,43860,Konya,Selçuklu
45-49,18800,19615,38415,Konya,Selçuklu
50-54,16108,16895,33003,Konya,Selçuklu
55-59,13493,14092,27585,Konya,Selçuklu
60-64,10655,11220,21875,Konya,Selçuklu
65-69,7425,8178,15603,Konya,Selçuklu
70-74,4626,5381,10007,Konya,Selçuklu
75+,4993,7166,12159,Konya,Selçuklu
18-24,1359,1403,2762,Trabzon,Sürmene
25-29,853,847,1700,Trabzon,Sürmene
30-34,840,766,1606,Trabzon,Sürmene
35-39,822,781,1603,Trabzon,Sürmene
40-44,756,793,1549,Trabzon,Sürmene
45-49,820,829,1649,Trabzon,Sürmene
50-54,772,826,1598,Trabzon,Sürmene
55-59,849,802,1651,Trabzon,Sürmene
60-64,737,844,1581,Trabzon,Sürmene
65-69,637,595,1232,Trabzon,Sürmene
70-74,451,601,1052,Trabzon,Sürmene
75+,597,1139,1736,Trabzon,Sürmene
18-24,2076,2081,4157,Bursa,İznik
25-29,1263,1204,2467,Bursa,İznik
30-34,1375,1275,2650,Bursa,İznik
35-39,1551,1605,3156,Bursa,İznik
40-44,1477,1578,3055,Bursa,İznik
45-49,1642,1609,3251,Bursa,İznik
50-54,1608,1596,3204,Bursa,İznik
55-59,1538,1584,3122,Bursa,İznik
60-64,1326,1306,2632,Bursa,İznik
65-69,1041,1126,2167,Bursa,İznik
70-74,674,901,1575,Bursa,İznik
75+,1010,1507,2517,Bursa,İznik
18-24,423,379,802,Çankırı,Orta
25-29,258,199,457,Çankırı,Orta
30-34,247,177,424,Çankırı,Orta
35-39,289,236,525,Çankırı,Orta
40-44,259,204,463,Çankırı,Orta
45-49,276,279,555,Çankırı,Orta
50-54,339,348,687,Çankırı,Orta
55-59,419,390,809,Çankırı,Orta
60-64,456,460,916,Çankırı,Orta
65-69,406,501,907,Çankırı,Orta
70-74,356,376,732,Çankırı,Orta
75+,482,620,1102,Çankırı,Orta
18-24,109,118,227,Ankara,Evren
25-29,70,49,119,Ankara,Evren
30-34,72,48,120,Ankara,Evren
35-39,66,63,129,Ankara,Evren
40-44,70,76,146,Ankara,Evren
45-49,92,85,177,Ankara,Evren
50-54,104,102,206,Ankara,Evren
55-59,115,134,249,Ankara,Evren
60-64,123,128,251,Ankara,Evren
65-69,125,127,252,Ankara,Evren
70-74,65,109,174,Ankara,Evren
75+,118,174,292,Ankara,Evren
18-24,313,269,582,Yalova,Termal
25-29,198,171,369,Yalova,Termal
30-34,164,169,333,Yalova,Termal
35-39,185,170,355,Yalova,Termal
40-44,172,192,364,Yalova,Termal
45-49,196,207,403,Yalova,Termal
50-54,199,176,375,Yalova,Termal
55-59,172,172,344,Yalova,Termal
60-64,147,152,299,Yalova,Termal
65-69,119,126,245,Yalova,Termal
70-74,88,112,200,Yalova,Termal
75+,134,158,292,Yalova,Termal
18-24,505,467,972,Kayseri,Sarız
25-29,318,258,576,Kayseri,Sarız
30-34,292,205,497,Kayseri,Sarız
35-39,317,234,551,Kayseri,Sarız
40-44,273,229,502,Kayseri,Sarız
45-49,286,288,574,Kayseri,Sarız
50-54,302,294,596,Kayseri,Sarız
55-59,302,339,641,Kayseri,Sarız
60-64,339,316,655,Kayseri,Sarız
65-69,292,353,645,Kayseri,Sarız
70-74,282,321,603,Kayseri,Sarız
75+,453,580,1033,Kayseri,Sarız
18-24,4180,4087,8267,İzmir,Aliağa
25-29,3824,3709,7533,İzmir,Aliağa
30-34,4440,3946,8386,İzmir,Aliağa
35-39,4365,3763,8128,İzmir,Aliağa
40-44,3353,3028,6381,İzmir,Aliağa
45-49,2880,2808,5688,İzmir,Aliağa
50-54,2674,2661,5335,İzmir,Aliağa
55-59,2601,2192,4793,İzmir,Aliağa
60-64,1778,1630,3408,İzmir,Aliağa
65-69,1230,1236,2466,İzmir,Aliağa
70-74,744,837,1581,İzmir,Aliağa
75+,901,1214,2115,İzmir,Aliağa
18-24,751,687,1438,Ordu,Ulubey
25-29,424,325,749,Ordu,Ulubey
30-34,401,268,669,Ordu,Ulubey
35-39,396,354,750,Ordu,Ulubey
40-44,437,404,841,Ordu,Ulubey
45-49,582,537,1119,Ordu,Ulubey
50-54,766,686,1452,Ordu,Ulubey
55-59,762,753,1515,Ordu,Ulubey
60-64,773,809,1582,Ordu,Ulubey
65-69,638,758,1396,Ordu,Ulubey
70-74,510,597,1107,Ordu,Ulubey
75+,865,1096,1961,Ordu,Ulubey
18-24,6037,6446,12483,Trabzon,Akçaabat
25-29,4311,4333,8644,Trabzon,Akçaabat
30-34,4553,4404,8957,Trabzon,Akçaabat
35-39,4754,4501,9255,Trabzon,Akçaabat
40-44,4244,3958,8202,Trabzon,Akçaabat
45-49,4015,3774,7789,Trabzon,Akçaabat
50-54,3805,3813,7618,Trabzon,Akçaabat
55-59,3422,3528,6950,Trabzon,Akçaabat
60-64,2970,3206,6176,Trabzon,Akçaabat
65-69,2268,2158,4426,Trabzon,Akçaabat
70-74,1337,1808,3145,Trabzon,Akçaabat
75+,1977,3449,5426,Trabzon,Akçaabat
18-24,212,193,405,Kırşehir,Akçakent
25-29,113,54,167,Kırşehir,Akçakent
30-34,77,66,143,Kırşehir,Akçakent
35-39,82,62,144,Kırşehir,Akçakent
40-44,91,123,214,Kırşehir,Akçakent
45-49,135,103,238,Kırşehir,Akçakent
50-54,137,108,245,Kırşehir,Akçakent
55-59,118,170,288,Kırşehir,Akçakent
60-64,151,172,323,Kırşehir,Akçakent
65-69,131,180,311,Kırşehir,Akçakent
70-74,100,149,249,Kırşehir,Akçakent
75+,170,274,444,Kırşehir,Akçakent
18-24,1466,1384,2850,Balıkesir,Sındırgı
25-29,725,698,1423,Balıkesir,Sındırgı
30-34,729,625,1354,Balıkesir,Sındırgı
35-39,801,797,1598,Balıkesir,Sındırgı
40-44,952,1028,1980,Balıkesir,Sındırgı
45-49,1217,1266,2483,Balıkesir,Sındırgı
50-54,1381,1478,2859,Balıkesir,Sındırgı
55-59,1387,1475,2862,Balıkesir,Sındırgı
60-64,1323,1430,2753,Balıkesir,Sındırgı
65-69,1193,1426,2619,Balıkesir,Sındırgı
70-74,1018,1198,2216,Balıkesir,Sındırgı
75+,1577,2247,3824,Balıkesir,Sındırgı
18-24,1384,1417,2801,Giresun,Görele
25-29,719,829,1548,Giresun,Görele
30-34,833,777,1610,Giresun,Görele
35-39,892,909,1801,Giresun,Görele
40-44,937,897,1834,Giresun,Görele
45-49,889,903,1792,Giresun,Görele
50-54,1070,1033,2103,Giresun,Görele
55-59,1221,1138,2359,Giresun,Görele
60-64,1186,1159,2345,Giresun,Görele
65-69,870,889,1759,Giresun,Görele
70-74,554,735,1289,Giresun,Görele
75+,1195,1778,2973,Giresun,Görele
18-24,66,54,120,Çankırı,Bayramören
25-29,55,39,94,Çankırı,Bayramören
30-34,42,23,65,Çankırı,Bayramören
35-39,46,26,72,Çankırı,Bayramören
40-44,38,41,79,Çankırı,Bayramören
45-49,49,48,97,Çankırı,Bayramören
50-54,84,86,170,Çankırı,Bayramören
55-59,128,115,243,Çankırı,Bayramören
60-64,143,137,280,Çankırı,Bayramören
65-69,134,128,262,Çankırı,Bayramören
70-74,87,91,178,Çankırı,Bayramören
75+,169,193,362,Çankırı,Bayramören
18-24,2800,3000,5800,Antalya,Döşemealtı
25-29,2019,2092,4111,Antalya,Döşemealtı
30-34,2193,2189,4382,Antalya,Döşemealtı
35-39,2389,2363,4752,Antalya,Döşemealtı
40-44,2336,2162,4498,Antalya,Döşemealtı
45-49,2077,1993,4070,Antalya,Döşemealtı
50-54,1858,1836,3694,Antalya,Döşemealtı
55-59,1634,1639,3273,Antalya,Döşemealtı
60-64,1293,1260,2553,Antalya,Döşemealtı
65-69,904,889,1793,Antalya,Döşemealtı
70-74,614,679,1293,Antalya,Döşemealtı
75+,757,1011,1768,Antalya,Döşemealtı
18-24,821,852,1673,Balıkesir,Manyas
25-29,529,474,1003,Balıkesir,Manyas
30-34,562,445,1007,Balıkesir,Manyas
35-39,520,477,997,Balıkesir,Manyas
40-44,582,595,1177,Balıkesir,Manyas
45-49,692,663,1355,Balıkesir,Manyas
50-54,716,694,1410,Balıkesir,Manyas
55-59,800,809,1609,Balıkesir,Manyas
60-64,747,785,1532,Balıkesir,Manyas
65-69,692,684,1376,Balıkesir,Manyas
70-74,487,554,1041,Balıkesir,Manyas
75+,736,1129,1865,Balıkesir,Manyas
18-24,976,1022,1998,Artvin,Yusufeli
25-29,627,591,1218,Artvin,Yusufeli
30-34,635,528,1163,Artvin,Yusufeli
35-39,635,557,1192,Artvin,Yusufeli
40-44,623,594,1217,Artvin,Yusufeli
45-49,638,616,1254,Artvin,Yusufeli
50-54,700,750,1450,Artvin,Yusufeli
55-59,724,716,1440,Artvin,Yusufeli
60-64,768,956,1724,Artvin,Yusufeli
65-69,590,707,1297,Artvin,Yusufeli
70-74,530,602,1132,Artvin,Yusufeli
75+,1021,1051,2072,Artvin,Yusufeli
18-24,503,403,906,Bursa,Keles
25-29,268,255,523,Bursa,Keles
30-34,254,242,496,Bursa,Keles
35-39,284,285,569,Bursa,Keles
40-44,313,312,625,Bursa,Keles
45-49,347,373,720,Bursa,Keles
50-54,400,437,837,Bursa,Keles
55-59,476,601,1077,Bursa,Keles
60-64,491,476,967,Bursa,Keles
65-69,461,530,991,Bursa,Keles
70-74,308,408,716,Bursa,Keles
75+,671,845,1516,Bursa,Keles
18-24,8756,8403,17159,Edirne,Edirne Merkez
25-29,6244,6011,12255,Edirne,Edirne Merkez
30-34,6483,6271,12754,Edirne,Edirne Merkez
35-39,6840,6689,13529,Edirne,Edirne Merkez
40-44,6209,6381,12590,Edirne,Edirne Merkez
45-49,5613,5779,11392,Edirne,Edirne Merkez
50-54,5620,5896,11516,Edirne,Edirne Merkez
55-59,5490,5795,11285,Edirne,Edirne Merkez
60-64,4851,4998,9849,Edirne,Edirne Merkez
65-69,3362,3410,6772,Edirne,Edirne Merkez
70-74,1958,2309,4267,Edirne,Edirne Merkez
75+,2442,3855,6297,Edirne,Edirne Merkez
18-24,1683,1944,3627,Afyonkarahisar,Emirdağ
25-29,1187,1179,2366,Afyonkarahisar,Emirdağ
30-34,1303,1128,2431,Afyonkarahisar,Emirdağ
35-39,1179,1064,2243,Afyonkarahisar,Emirdağ
40-44,1037,1035,2072,Afyonkarahisar,Emirdağ
45-49,1086,1109,2195,Afyonkarahisar,Emirdağ
50-54,1238,1298,2536,Afyonkarahisar,Emirdağ
55-59,1252,1322,2574,Afyonkarahisar,Emirdağ
60-64,1050,1163,2213,Afyonkarahisar,Emirdağ
65-69,890,950,1840,Afyonkarahisar,Emirdağ
70-74,707,780,1487,Afyonkarahisar,Emirdağ
75+,998,1280,2278,Afyonkarahisar,Emirdağ
18-24,10140,10363,20503,Şırnak,Cizre
25-29,7256,6197,13453,Şırnak,Cizre
30-34,5079,4463,9542,Şırnak,Cizre
35-39,4074,4278,8352,Şırnak,Cizre
40-44,2831,3083,5914,Şırnak,Cizre
45-49,2288,2198,4486,Şırnak,Cizre
50-54,1932,1843,3775,Şırnak,Cizre
55-59,1294,1184,2478,Şırnak,Cizre
60-64,1024,995,2019,Şırnak,Cizre
65-69,617,796,1413,Şırnak,Cizre
70-74,416,566,982,Şırnak,Cizre
75+,563,1041,1604,Şırnak,Cizre
18-24,289,232,521,Tunceli,Hozat
25-29,367,186,553,Tunceli,Hozat
30-34,268,159,427,Tunceli,Hozat
35-39,264,178,442,Tunceli,Hozat
40-44,240,145,385,Tunceli,Hozat
45-49,180,143,323,Tunceli,Hozat
50-54,157,172,329,Tunceli,Hozat
55-59,149,153,302,Tunceli,Hozat
60-64,151,159,310,Tunceli,Hozat
65-69,145,155,300,Tunceli,Hozat
70-74,79,117,196,Tunceli,Hozat
75+,168,244,412,Tunceli,Hozat
18-24,2503,2689,5192,Diyarbakır,Kulp
25-29,1549,1377,2926,Diyarbakır,Kulp
30-34,1045,1011,2056,Diyarbakır,Kulp
35-39,1117,1273,2390,Diyarbakır,Kulp
40-44,774,834,1608,Diyarbakır,Kulp
45-49,613,668,1281,Diyarbakır,Kulp
50-54,652,662,1314,Diyarbakır,Kulp
55-59,518,508,1026,Diyarbakır,Kulp
60-64,507,473,980,Diyarbakır,Kulp
65-69,403,500,903,Diyarbakır,Kulp
70-74,327,410,737,Diyarbakır,Kulp
75+,441,625,1066,Diyarbakır,Kulp
18-24,22611,22612,45223,İstanbul,Kartal
25-29,18102,18433,36535,İstanbul,Kartal
30-34,19706,20165,39871,İstanbul,Kartal
35-39,21300,21477,42777,İstanbul,Kartal
40-44,19040,19660,38700,İstanbul,Kartal
45-49,16999,17464,34463,İstanbul,Kartal
50-54,14504,14890,29394,İstanbul,Kartal
55-59,12162,12248,24410,İstanbul,Kartal
60-64,9191,9589,18780,İstanbul,Kartal
65-69,6292,7184,13476,İstanbul,Kartal
70-74,4022,4781,8803,İstanbul,Kartal
75+,4784,7610,12394,İstanbul,Kartal
18-24,434,521,955,Sivas,Koyulhisar
25-29,304,279,583,Sivas,Koyulhisar
30-34,282,248,530,Sivas,Koyulhisar
35-39,295,226,521,Sivas,Koyulhisar
40-44,261,275,536,Sivas,Koyulhisar
45-49,326,288,614,Sivas,Koyulhisar
50-54,381,433,814,Sivas,Koyulhisar
55-59,529,568,1097,Sivas,Koyulhisar
60-64,669,653,1322,Sivas,Koyulhisar
65-69,571,660,1231,Sivas,Koyulhisar
70-74,409,512,921,Sivas,Koyulhisar
75+,673,924,1597,Sivas,Koyulhisar
18-24,1679,1765,3444,Manisa,Kırkağaç
25-29,1203,1173,2376,Manisa,Kırkağaç
30-34,1367,1295,2662,Manisa,Kırkağaç
35-39,1382,1293,2675,Manisa,Kırkağaç
40-44,1332,1382,2714,Manisa,Kırkağaç
45-49,1292,1301,2593,Manisa,Kırkağaç
50-54,1234,1317,2551,Manisa,Kırkağaç
55-59,1282,1300,2582,Manisa,Kırkağaç
60-64,1114,1140,2254,Manisa,Kırkağaç
65-69,836,956,1792,Manisa,Kırkağaç
70-74,648,753,1401,Manisa,Kırkağaç
75+,886,1326,2212,Manisa,Kırkağaç
18-24,1099,921,2020,Giresun,Dereli
25-29,567,432,999,Giresun,Dereli
30-34,545,398,943,Giresun,Dereli
35-39,502,422,924,Giresun,Dereli
40-44,495,468,963,Giresun,Dereli
45-49,620,565,1185,Giresun,Dereli
50-54,764,734,1498,Giresun,Dereli
55-59,850,807,1657,Giresun,Dereli
60-64,815,849,1664,Giresun,Dereli
65-69,705,658,1363,Giresun,Dereli
70-74,411,508,919,Giresun,Dereli
75+,801,1155,1956,Giresun,Dereli
18-24,716,613,1329,Konya,Hadim
25-29,408,329,737,Konya,Hadim
30-34,383,309,692,Konya,Hadim
35-39,341,337,678,Konya,Hadim
40-44,344,306,650,Konya,Hadim
45-49,382,335,717,Konya,Hadim
50-54,338,335,673,Konya,Hadim
55-59,346,375,721,Konya,Hadim
60-64,312,300,612,Konya,Hadim
65-69,233,336,569,Konya,Hadim
70-74,211,341,552,Konya,Hadim
75+,414,675,1089,Konya,Hadim
18-24,6064,6271,12335,İzmir,Gaziemir
25-29,4699,4983,9682,İzmir,Gaziemir
30-34,5269,5668,10937,İzmir,Gaziemir
35-39,6061,6555,12616,İzmir,Gaziemir
40-44,5666,5879,11545,İzmir,Gaziemir
45-49,4987,5025,10012,İzmir,Gaziemir
50-54,4350,4270,8620,İzmir,Gaziemir
55-59,3802,3733,7535,İzmir,Gaziemir
60-64,2875,2861,5736,İzmir,Gaziemir
65-69,1957,2023,3980,İzmir,Gaziemir
70-74,1137,1320,2457,İzmir,Gaziemir
75+,1203,1780,2983,İzmir,Gaziemir
18-24,789,860,1649,Kütahya,Emet
25-29,550,539,1089,Kütahya,Emet
30-34,638,665,1303,Kütahya,Emet
35-39,724,691,1415,Kütahya,Emet
40-44,710,697,1407,Kütahya,Emet
45-49,670,685,1355,Kütahya,Emet
50-54,682,656,1338,Kütahya,Emet
55-59,622,767,1389,Kütahya,Emet
60-64,573,687,1260,Kütahya,Emet
65-69,527,686,1213,Kütahya,Emet
70-74,366,536,902,Kütahya,Emet
75+,617,951,1568,Kütahya,Emet
18-24,822,864,1686,Manisa,Gölmarmara
25-29,539,478,1017,Manisa,Gölmarmara
30-34,521,402,923,Manisa,Gölmarmara
35-39,451,504,955,Manisa,Gölmarmara
40-44,500,499,999,Manisa,Gölmarmara
45-49,520,513,1033,Manisa,Gölmarmara
50-54,524,469,993,Manisa,Gölmarmara
55-59,487,472,959,Manisa,Gölmarmara
60-64,403,418,821,Manisa,Gölmarmara
65-69,315,388,703,Manisa,Gölmarmara
70-74,232,257,489,Manisa,Gölmarmara
75+,287,468,755,Manisa,Gölmarmara
18-24,519,511,1030,Tunceli,Pertek
25-29,504,343,847,Tunceli,Pertek
30-34,444,358,802,Tunceli,Pertek
35-39,477,382,859,Tunceli,Pertek
40-44,425,309,734,Tunceli,Pertek
45-49,390,365,755,Tunceli,Pertek
50-54,326,374,700,Tunceli,Pertek
55-59,357,339,696,Tunceli,Pertek
60-64,298,355,653,Tunceli,Pertek
65-69,212,282,494,Tunceli,Pertek
70-74,174,180,354,Tunceli,Pertek
75+,386,503,889,Tunceli,Pertek
18-24,2087,2142,4229,Malatya,Doğanşehir
25-29,1222,1193,2415,Malatya,Doğanşehir
30-34,1276,1223,2499,Malatya,Doğanşehir
35-39,1371,1348,2719,Malatya,Doğanşehir
40-44,1331,1240,2571,Malatya,Doğanşehir
45-49,1258,1242,2500,Malatya,Doğanşehir
50-54,1229,1103,2332,Malatya,Doğanşehir
55-59,1122,983,2105,Malatya,Doğanşehir
60-64,1018,881,1899,Malatya,Doğanşehir
65-69,731,858,1589,Malatya,Doğanşehir
70-74,610,756,1366,Malatya,Doğanşehir
75+,1022,1363,2385,Malatya,Doğanşehir
18-24,72,88,160,Afyonkarahisar,Kızılören
25-29,59,43,102,Afyonkarahisar,Kızılören
30-34,53,43,96,Afyonkarahisar,Kızılören
35-39,67,41,108,Afyonkarahisar,Kızılören
40-44,52,59,111,Afyonkarahisar,Kızılören
45-49,78,75,153,Afyonkarahisar,Kızılören
50-54,91,102,193,Afyonkarahisar,Kızılören
55-59,106,124,230,Afyonkarahisar,Kızılören
60-64,83,119,202,Afyonkarahisar,Kızılören
65-69,91,101,192,Afyonkarahisar,Kızılören
70-74,65,96,161,Afyonkarahisar,Kızılören
75+,108,185,293,Afyonkarahisar,Kızılören
18-24,192,193,385,Kastamonu,Seydiler
25-29,129,110,239,Kastamonu,Seydiler
30-34,109,105,214,Kastamonu,Seydiler
35-39,135,128,263,Kastamonu,Seydiler
40-44,123,104,227,Kastamonu,Seydiler
45-49,121,144,265,Kastamonu,Seydiler
50-54,130,116,246,Kastamonu,Seydiler
55-59,139,110,249,Kastamonu,Seydiler
60-64,135,156,291,Kastamonu,Seydiler
65-69,132,147,279,Kastamonu,Seydiler
70-74,102,117,219,Kastamonu,Seydiler
75+,129,189,318,Kastamonu,Seydiler
18-24,2718,2717,5435,Amasya,Suluova
25-29,1526,1512,3038,Amasya,Suluova
30-34,1643,1584,3227,Amasya,Suluova
35-39,1674,1725,3399,Amasya,Suluova
40-44,1541,1574,3115,Amasya,Suluova
45-49,1582,1479,3061,Amasya,Suluova
50-54,1563,1561,3124,Amasya,Suluova
55-59,1330,1417,2747,Amasya,Suluova
60-64,1154,1181,2335,Amasya,Suluova
65-69,936,1060,1996,Amasya,Suluova
70-74,655,821,1476,Amasya,Suluova
75+,982,1221,2203,Amasya,Suluova
18-24,24241,25082,49323,Şanlıurfa,Eyyübiye
25-29,14662,14119,28781,Şanlıurfa,Eyyübiye
30-34,11728,11395,23123,Şanlıurfa,Eyyübiye
35-39,10397,10782,21179,Şanlıurfa,Eyyübiye
40-44,7715,7848,15563,Şanlıurfa,Eyyübiye
45-49,6248,6097,12345,Şanlıurfa,Eyyübiye
50-54,5500,5293,10793,Şanlıurfa,Eyyübiye
55-59,3762,4406,8168,Şanlıurfa,Eyyübiye
60-64,2916,3106,6022,Şanlıurfa,Eyyübiye
65-69,2138,2375,4513,Şanlıurfa,Eyyübiye
70-74,1278,1610,2888,Şanlıurfa,Eyyübiye
75+,1606,2668,4274,Şanlıurfa,Eyyübiye
18-24,1615,1680,3295,Afyonkarahisar,Çay
25-29,878,867,1745,Afyonkarahisar,Çay
30-34,945,926,1871,Afyonkarahisar,Çay
35-39,992,1038,2030,Afyonkarahisar,Çay
40-44,949,1074,2023,Afyonkarahisar,Çay
45-49,1051,1087,2138,Afyonkarahisar,Çay
50-54,1073,1094,2167,Afyonkarahisar,Çay
55-59,1091,1116,2207,Afyonkarahisar,Çay
60-64,955,1053,2008,Afyonkarahisar,Çay
65-69,751,823,1574,Afyonkarahisar,Çay
70-74,446,550,996,Afyonkarahisar,Çay
75+,595,941,1536,Afyonkarahisar,Çay
18-24,104,135,239,Burdur,Kemer
25-29,62,69,131,Burdur,Kemer
30-34,90,61,151,Burdur,Kemer
35-39,91,85,176,Burdur,Kemer
40-44,90,77,167,Burdur,Kemer
45-49,91,111,202,Burdur,Kemer
50-54,112,128,240,Burdur,Kemer
55-59,135,134,269,Burdur,Kemer
60-64,121,152,273,Burdur,Kemer
65-69,129,150,279,Burdur,Kemer
70-74,86,125,211,Burdur,Kemer
75+,167,225,392,Burdur,Kemer
18-24,1568,1689,3257,Nevşehir,Ürgüp
25-29,1034,1027,2061,Nevşehir,Ürgüp
30-34,1249,1294,2543,Nevşehir,Ürgüp
35-39,1245,1282,2527,Nevşehir,Ürgüp
40-44,1188,1111,2299,Nevşehir,Ürgüp
45-49,1168,1158,2326,Nevşehir,Ürgüp
50-54,1128,1207,2335,Nevşehir,Ürgüp
55-59,1125,1054,2179,Nevşehir,Ürgüp
60-64,950,925,1875,Nevşehir,Ürgüp
65-69,692,856,1548,Nevşehir,Ürgüp
70-74,630,782,1412,Nevşehir,Ürgüp
75+,899,1389,2288,Nevşehir,Ürgüp
18-24,315,296,611,Ankara,Güdül
25-29,200,147,347,Ankara,Güdül
30-34,194,147,341,Ankara,Güdül
35-39,183,173,356,Ankara,Güdül
40-44,214,198,412,Ankara,Güdül
45-49,241,248,489,Ankara,Güdül
50-54,299,303,602,Ankara,Güdül
55-59,345,420,765,Ankara,Güdül
60-64,391,358,749,Ankara,Güdül
65-69,338,374,712,Ankara,Güdül
70-74,218,287,505,Ankara,Güdül
75+,450,694,1144,Ankara,Güdül
18-24,320,294,614,Rize,Çamlıhemşin
25-29,232,175,407,Rize,Çamlıhemşin
30-34,197,149,346,Rize,Çamlıhemşin
35-39,220,162,382,Rize,Çamlıhemşin
40-44,202,187,389,Rize,Çamlıhemşin
45-49,208,214,422,Rize,Çamlıhemşin
50-54,225,258,483,Rize,Çamlıhemşin
55-59,230,270,500,Rize,Çamlıhemşin
60-64,224,228,452,Rize,Çamlıhemşin
65-69,200,195,395,Rize,Çamlıhemşin
70-74,142,210,352,Rize,Çamlıhemşin
75+,180,398,578,Rize,Çamlıhemşin
18-24,12186,13000,25186,Hatay,İskenderun
25-29,8449,8830,17279,Hatay,İskenderun
30-34,9085,9814,18899,Hatay,İskenderun
35-39,10013,10571,20584,Hatay,İskenderun
40-44,9353,9273,18626,Hatay,İskenderun
45-49,7802,7622,15424,Hatay,İskenderun
50-54,7095,7363,14458,Hatay,İskenderun
55-59,5981,6346,12327,Hatay,İskenderun
60-64,5103,5309,10412,Hatay,İskenderun
65-69,3896,3681,7577,Hatay,İskenderun
70-74,2081,2384,4465,Hatay,İskenderun
75+,2485,3579,6064,Hatay,İskenderun
18-24,124,141,265,Kastamonu,Pınarbaşı
25-29,133,96,229,Kastamonu,Pınarbaşı
30-34,146,80,226,Kastamonu,Pınarbaşı
35-39,127,89,216,Kastamonu,Pınarbaşı
40-44,115,93,208,Kastamonu,Pınarbaşı
45-49,111,105,216,Kastamonu,Pınarbaşı
50-54,186,194,380,Kastamonu,Pınarbaşı
55-59,293,263,556,Kastamonu,Pınarbaşı
60-64,310,314,624,Kastamonu,Pınarbaşı
65-69,317,305,622,Kastamonu,Pınarbaşı
70-74,261,215,476,Kastamonu,Pınarbaşı
75+,341,407,748,Kastamonu,Pınarbaşı
18-24,8320,6478,14798,Kastamonu,Kastamonu Merkez
25-29,5732,4851,10583,Kastamonu,Kastamonu Merkez
30-34,5192,5460,10652,Kastamonu,Kastamonu Merkez
35-39,5626,5952,11578,Kastamonu,Kastamonu Merkez
40-44,4857,5035,9892,Kastamonu,Kastamonu Merkez
45-49,4248,4432,8680,Kastamonu,Kastamonu Merkez
50-54,3955,4048,8003,Kastamonu,Kastamonu Merkez
55-59,3642,3865,7507,Kastamonu,Kastamonu Merkez
60-64,3326,3519,6845,Kastamonu,Kastamonu Merkez
65-69,2413,2776,5189,Kastamonu,Kastamonu Merkez
70-74,1596,2083,3679,Kastamonu,Kastamonu Merkez
75+,2003,3438,5441,Kastamonu,Kastamonu Merkez
18-24,510,559,1069,Yozgat,Aydıncık
25-29,323,283,606,Yozgat,Aydıncık
30-34,281,252,533,Yozgat,Aydıncık
35-39,291,263,554,Yozgat,Aydıncık
40-44,264,253,517,Yozgat,Aydıncık
45-49,279,258,537,Yozgat,Aydıncık
50-54,271,311,582,Yozgat,Aydıncık
55-59,257,272,529,Yozgat,Aydıncık
60-64,288,288,576,Yozgat,Aydıncık
65-69,290,322,612,Yozgat,Aydıncık
70-74,190,258,448,Yozgat,Aydıncık
75+,309,423,732,Yozgat,Aydıncık
18-24,600,549,1149,Mersin,Aydıncık
25-29,307,305,612,Mersin,Aydıncık
30-34,367,310,677,Mersin,Aydıncık
35-39,433,403,836,Mersin,Aydıncık
40-44,450,477,927,Mersin,Aydıncık
45-49,394,431,825,Mersin,Aydıncık
50-54,445,381,826,Mersin,Aydıncık
55-59,325,304,629,Mersin,Aydıncık
60-64,265,298,563,Mersin,Aydıncık
65-69,211,237,448,Mersin,Aydıncık
70-74,143,176,319,Mersin,Aydıncık
75+,283,358,641,Mersin,Aydıncık
18-24,1095,1044,2139,Samsun,Salıpazarı
25-29,521,486,1007,Samsun,Salıpazarı
30-34,475,459,934,Samsun,Salıpazarı
35-39,599,550,1149,Samsun,Salıpazarı
40-44,588,590,1178,Samsun,Salıpazarı
45-49,603,535,1138,Samsun,Salıpazarı
50-54,692,612,1304,Samsun,Salıpazarı
55-59,694,570,1264,Samsun,Salıpazarı
60-64,615,590,1205,Samsun,Salıpazarı
65-69,505,531,1036,Samsun,Salıpazarı
70-74,378,453,831,Samsun,Salıpazarı
75+,519,738,1257,Samsun,Salıpazarı
18-24,334,315,649,Sivas,Hafik
25-29,194,157,351,Sivas,Hafik
30-34,225,180,405,Sivas,Hafik
35-39,254,195,449,Sivas,Hafik
40-44,237,193,430,Sivas,Hafik
45-49,190,225,415,Sivas,Hafik
50-54,244,325,569,Sivas,Hafik
55-59,356,396,752,Sivas,Hafik
60-64,514,561,1075,Sivas,Hafik
65-69,591,552,1143,Sivas,Hafik
70-74,391,372,763,Sivas,Hafik
75+,597,638,1235,Sivas,Hafik
18-24,463,477,940,Tokat,Sulusaray
25-29,254,222,476,Tokat,Sulusaray
30-34,267,236,503,Tokat,Sulusaray
35-39,216,230,446,Tokat,Sulusaray
40-44,213,241,454,Tokat,Sulusaray
45-49,211,210,421,Tokat,Sulusaray
50-54,226,208,434,Tokat,Sulusaray
55-59,181,180,361,Tokat,Sulusaray
60-64,160,189,349,Tokat,Sulusaray
65-69,181,180,361,Tokat,Sulusaray
70-74,100,119,219,Tokat,Sulusaray
75+,153,193,346,Tokat,Sulusaray
18-24,11403,11675,23078,Düzce,Düzce Merkez
25-29,8201,8370,16571,Düzce,Düzce Merkez
30-34,8628,8886,17514,Düzce,Düzce Merkez
35-39,9513,9540,19053,Düzce,Düzce Merkez
40-44,8666,8283,16949,Düzce,Düzce Merkez
45-49,7386,7392,14778,Düzce,Düzce Merkez
50-54,6399,6271,12670,Düzce,Düzce Merkez
55-59,5854,5981,11835,Düzce,Düzce Merkez
60-64,4813,4883,9696,Düzce,Düzce Merkez
65-69,3356,3670,7026,Düzce,Düzce Merkez
70-74,2126,2538,4664,Düzce,Düzce Merkez
75+,2866,4224,7090,Düzce,Düzce Merkez
18-24,583,583,1166,Ankara,Kalecik
25-29,359,306,665,Ankara,Kalecik
30-34,334,291,625,Ankara,Kalecik
35-39,343,333,676,Ankara,Kalecik
40-44,336,325,661,Ankara,Kalecik
45-49,395,404,799,Ankara,Kalecik
50-54,479,464,943,Ankara,Kalecik
55-59,448,472,920,Ankara,Kalecik
60-64,450,464,914,Ankara,Kalecik
65-69,397,521,918,Ankara,Kalecik
70-74,298,363,661,Ankara,Kalecik
75+,523,611,1134,Ankara,Kalecik
18-24,1982,2020,4002,Çanakkale,Çan
25-29,1433,1349,2782,Çanakkale,Çan
30-34,1677,1590,3267,Çanakkale,Çan
35-39,2037,1944,3981,Çanakkale,Çan
40-44,1975,1727,3702,Çanakkale,Çan
45-49,1666,1710,3376,Çanakkale,Çan
50-54,1904,1757,3661,Çanakkale,Çan
55-59,1764,1746,3510,Çanakkale,Çan
60-64,1498,1501,2999,Çanakkale,Çan
65-69,1128,1248,2376,Çanakkale,Çan
70-74,728,967,1695,Çanakkale,Çan
75+,1229,1846,3075,Çanakkale,Çan
18-24,19929,20464,40393,Konya,Meram
25-29,11675,11950,23625,Konya,Meram
30-34,12407,12653,25060,Konya,Meram
35-39,12534,12807,25341,Konya,Meram
40-44,11055,11422,22477,Konya,Meram
45-49,10035,10380,20415,Konya,Meram
50-54,8813,9043,17856,Konya,Meram
55-59,7826,8098,15924,Konya,Meram
60-64,6167,6625,12792,Konya,Meram
65-69,4762,5464,10226,Konya,Meram
70-74,3354,4012,7366,Konya,Meram
75+,4544,5829,10373,Konya,Meram
18-24,272,259,531,Kütahya,Şaphane
25-29,154,107,261,Kütahya,Şaphane
30-34,140,128,268,Kütahya,Şaphane
35-39,165,155,320,Kütahya,Şaphane
40-44,151,187,338,Kütahya,Şaphane
45-49,208,214,422,Kütahya,Şaphane
50-54,243,257,500,Kütahya,Şaphane
55-59,246,282,528,Kütahya,Şaphane
60-64,223,289,512,Kütahya,Şaphane
65-69,213,253,466,Kütahya,Şaphane
70-74,161,191,352,Kütahya,Şaphane
75+,290,345,635,Kütahya,Şaphane
18-24,155,185,340,Sivas,Akıncılar
25-29,109,115,224,Sivas,Akıncılar
30-34,113,92,205,Sivas,Akıncılar
35-39,134,119,253,Sivas,Akıncılar
40-44,136,118,254,Sivas,Akıncılar
45-49,138,106,244,Sivas,Akıncılar
50-54,171,148,319,Sivas,Akıncılar
55-59,258,231,489,Sivas,Akıncılar
60-64,259,237,496,Sivas,Akıncılar
65-69,244,271,515,Sivas,Akıncılar
70-74,180,240,420,Sivas,Akıncılar
75+,226,322,548,Sivas,Akıncılar
18-24,1620,1732,3352,Yalova,Çiftlikköy
25-29,1221,1141,2362,Yalova,Çiftlikköy
30-34,1281,1317,2598,Yalova,Çiftlikköy
35-39,1415,1401,2816,Yalova,Çiftlikköy
40-44,1326,1369,2695,Yalova,Çiftlikköy
45-49,1291,1246,2537,Yalova,Çiftlikköy
50-54,1083,1152,2235,Yalova,Çiftlikköy
55-59,1111,1109,2220,Yalova,Çiftlikköy
60-64,952,995,1947,Yalova,Çiftlikköy
65-69,741,770,1511,Yalova,Çiftlikköy
70-74,473,570,1043,Yalova,Çiftlikköy
75+,675,894,1569,Yalova,Çiftlikköy
18-24,1197,1326,2523,Nevşehir,Derinkuyu
25-29,648,545,1193,Nevşehir,Derinkuyu
30-34,703,677,1380,Nevşehir,Derinkuyu
35-39,810,769,1579,Nevşehir,Derinkuyu
40-44,775,717,1492,Nevşehir,Derinkuyu
45-49,711,721,1432,Nevşehir,Derinkuyu
50-54,577,569,1146,Nevşehir,Derinkuyu
55-59,515,529,1044,Nevşehir,Derinkuyu
60-64,395,469,864,Nevşehir,Derinkuyu
65-69,332,390,722,Nevşehir,Derinkuyu
70-74,196,298,494,Nevşehir,Derinkuyu
75+,274,481,755,Nevşehir,Derinkuyu
18-24,11868,12618,24486,İstanbul,Çekmeköy
25-29,9684,10679,20363,İstanbul,Çekmeköy
30-34,11377,11852,23229,İstanbul,Çekmeköy
35-39,12603,12374,24977,İstanbul,Çekmeköy
40-44,10578,10119,20697,İstanbul,Çekmeköy
45-49,8666,7947,16613,İstanbul,Çekmeköy
50-54,6770,6174,12944,İstanbul,Çekmeköy
55-59,4915,4645,9560,İstanbul,Çekmeköy
60-64,3356,3462,6818,İstanbul,Çekmeköy
65-69,2094,2269,4363,İstanbul,Çekmeköy
70-74,1211,1464,2675,İstanbul,Çekmeköy
75+,1264,2078,3342,İstanbul,Çekmeköy
18-24,542,533,1075,Tokat,Yeşilyurt
25-29,272,296,568,Tokat,Yeşilyurt
30-34,274,277,551,Tokat,Yeşilyurt
35-39,306,282,588,Tokat,Yeşilyurt
40-44,268,275,543,Tokat,Yeşilyurt
45-49,260,266,526,Tokat,Yeşilyurt
50-54,228,240,468,Tokat,Yeşilyurt
55-59,225,233,458,Tokat,Yeşilyurt
60-64,212,278,490,Tokat,Yeşilyurt
65-69,200,191,391,Tokat,Yeşilyurt
70-74,143,167,310,Tokat,Yeşilyurt
75+,192,199,391,Tokat,Yeşilyurt
18-24,208,194,402,Malatya,Doğanyol
25-29,123,136,259,Malatya,Doğanyol
30-34,153,132,285,Malatya,Doğanyol
35-39,144,137,281,Malatya,Doğanyol
40-44,119,109,228,Malatya,Doğanyol
45-49,105,105,210,Malatya,Doğanyol
50-54,122,102,224,Malatya,Doğanyol
55-59,111,141,252,Malatya,Doğanyol
60-64,113,112,225,Malatya,Doğanyol
65-69,101,100,201,Malatya,Doğanyol
70-74,74,100,174,Malatya,Doğanyol
75+,132,211,343,Malatya,Doğanyol
18-24,18626,19187,37813,Bursa,Nilüfer
25-29,14429,16295,30724,Bursa,Nilüfer
30-34,17435,19255,36690,Bursa,Nilüfer
35-39,19587,20967,40554,Bursa,Nilüfer
40-44,17764,18232,35996,Bursa,Nilüfer
45-49,15231,15384,30615,Bursa,Nilüfer
50-54,12982,12863,25845,Bursa,Nilüfer
55-59,10895,10801,21696,Bursa,Nilüfer
60-64,8570,8660,17230,Bursa,Nilüfer
65-69,6056,6192,12248,Bursa,Nilüfer
70-74,3425,3892,7317,Bursa,Nilüfer
75+,3617,5392,9009,Bursa,Nilüfer
18-24,394,420,814,Karaman,Ayrancı
25-29,218,162,380,Karaman,Ayrancı
30-34,232,194,426,Karaman,Ayrancı
35-39,267,206,473,Karaman,Ayrancı
40-44,235,215,450,Karaman,Ayrancı
45-49,255,294,549,Karaman,Ayrancı
50-54,267,273,540,Karaman,Ayrancı
55-59,306,289,595,Karaman,Ayrancı
60-64,257,293,550,Karaman,Ayrancı
65-69,248,282,530,Karaman,Ayrancı
70-74,157,226,383,Karaman,Ayrancı
75+,332,462,794,Karaman,Ayrancı
18-24,4019,4541,8560,Hatay,Arsuz
25-29,2505,2952,5457,Hatay,Arsuz
30-34,3106,3180,6286,Hatay,Arsuz
35-39,3550,3527,7077,Hatay,Arsuz
40-44,3193,3284,6477,Hatay,Arsuz
45-49,2911,3032,5943,Hatay,Arsuz
50-54,2757,2781,5538,Hatay,Arsuz
55-59,2279,2269,4548,Hatay,Arsuz
60-64,2003,2044,4047,Hatay,Arsuz
65-69,1354,1390,2744,Hatay,Arsuz
70-74,823,918,1741,Hatay,Arsuz
75+,1123,1286,2409,Hatay,Arsuz
18-24,3228,3415,6643,Amasya,Merzifon
25-29,2252,2394,4646,Amasya,Merzifon
30-34,2669,2720,5389,Amasya,Merzifon
35-39,2967,2904,5871,Amasya,Merzifon
40-44,2485,2506,4991,Amasya,Merzifon
45-49,2232,2343,4575,Amasya,Merzifon
50-54,2128,2294,4422,Amasya,Merzifon
55-59,2244,2389,4633,Amasya,Merzifon
60-64,1904,1934,3838,Amasya,Merzifon
65-69,1549,1733,3282,Amasya,Merzifon
70-74,1151,1375,2526,Amasya,Merzifon
75+,1641,2360,4001,Amasya,Merzifon
18-24,6961,6669,13630,Giresun,Giresun Merkez
25-29,4286,4610,8896,Giresun,Giresun Merkez
30-34,4680,4745,9425,Giresun,Giresun Merkez
35-39,4907,5161,10068,Giresun,Giresun Merkez
40-44,4733,4661,9394,Giresun,Giresun Merkez
45-49,4227,4359,8586,Giresun,Giresun Merkez
50-54,4300,4368,8668,Giresun,Giresun Merkez
55-59,4357,4358,8715,Giresun,Giresun Merkez
60-64,3675,3748,7423,Giresun,Giresun Merkez
65-69,2341,2342,4683,Giresun,Giresun Merkez
70-74,1431,1833,3264,Giresun,Giresun Merkez
75+,2339,3709,6048,Giresun,Giresun Merkez
18-24,678,694,1372,Hatay,Kumlu
25-29,389,399,788,Hatay,Kumlu
30-34,434,392,826,Hatay,Kumlu
35-39,431,446,877,Hatay,Kumlu
40-44,354,381,735,Hatay,Kumlu
45-49,326,368,694,Hatay,Kumlu
50-54,336,326,662,Hatay,Kumlu
55-59,302,299,601,Hatay,Kumlu
60-64,246,278,524,Hatay,Kumlu
65-69,171,205,376,Hatay,Kumlu
70-74,121,123,244,Hatay,Kumlu
75+,156,235,391,Hatay,Kumlu
18-24,597,635,1232,Balıkesir,Gömeç
25-29,382,348,730,Balıkesir,Gömeç
30-34,415,441,856,Balıkesir,Gömeç
35-39,515,491,1006,Balıkesir,Gömeç
40-44,483,435,918,Balıkesir,Gömeç
45-49,433,406,839,Balıkesir,Gömeç
50-54,445,459,904,Balıkesir,Gömeç
55-59,415,543,958,Balıkesir,Gömeç
60-64,548,604,1152,Balıkesir,Gömeç
65-69,484,499,983,Balıkesir,Gömeç
70-74,383,354,737,Balıkesir,Gömeç
75+,439,553,992,Balıkesir,Gömeç
18-24,520,570,1090,Batman,Hasankeyf
25-29,333,237,570,Batman,Hasankeyf
30-34,211,187,398,Batman,Hasankeyf
35-39,183,192,375,Batman,Hasankeyf
40-44,171,165,336,Batman,Hasankeyf
45-49,134,161,295,Batman,Hasankeyf
50-54,144,126,270,Batman,Hasankeyf
55-59,94,109,203,Batman,Hasankeyf
60-64,100,84,184,Batman,Hasankeyf
65-69,83,106,189,Batman,Hasankeyf
70-74,54,66,120,Batman,Hasankeyf
75+,85,132,217,Batman,Hasankeyf
18-24,5213,5537,10750,Tokat,Erbaa
25-29,2986,3039,6025,Tokat,Erbaa
30-34,3212,3191,6403,Tokat,Erbaa
35-39,3082,3202,6284,Tokat,Erbaa
40-44,2998,2958,5956,Tokat,Erbaa
45-49,2791,2803,5594,Tokat,Erbaa
50-54,2783,2807,5590,Tokat,Erbaa
55-59,2682,2781,5463,Tokat,Erbaa
60-64,2429,2641,5070,Tokat,Erbaa
65-69,1774,2143,3917,Tokat,Erbaa
70-74,1322,1839,3161,Tokat,Erbaa
75+,1894,2406,4300,Tokat,Erbaa
18-24,3020,2880,5900,Balıkesir,Ayvalık
25-29,2150,2061,4211,Balıkesir,Ayvalık
30-34,2183,2086,4269,Balıkesir,Ayvalık
35-39,2423,2403,4826,Balıkesir,Ayvalık
40-44,2249,2491,4740,Balıkesir,Ayvalık
45-49,2428,2575,5003,Balıkesir,Ayvalık
50-54,2584,2729,5313,Balıkesir,Ayvalık
55-59,2608,2959,5567,Balıkesir,Ayvalık
60-64,2600,2876,5476,Balıkesir,Ayvalık
65-69,2312,2480,4792,Balıkesir,Ayvalık
70-74,1846,1942,3788,Balıkesir,Ayvalık
75+,2244,2719,4963,Balıkesir,Ayvalık
18-24,8809,9624,18433,Adana,Sarıçam
25-29,5807,6131,11938,Adana,Sarıçam
30-34,6268,6184,12452,Adana,Sarıçam
35-39,6575,6347,12922,Adana,Sarıçam
40-44,6037,5699,11736,Adana,Sarıçam
45-49,5417,5257,10674,Adana,Sarıçam
50-54,4919,4499,9418,Adana,Sarıçam
55-59,3623,3419,7042,Adana,Sarıçam
60-64,2575,2346,4921,Adana,Sarıçam
65-69,1530,1644,3174,Adana,Sarıçam
70-74,802,960,1762,Adana,Sarıçam
75+,924,1412,2336,Adana,Sarıçam
18-24,1497,1349,2846,Ağrı,Taşlıçay
25-29,775,715,1490,Ağrı,Taşlıçay
30-34,608,561,1169,Ağrı,Taşlıçay
35-39,673,633,1306,Ağrı,Taşlıçay
40-44,474,407,881,Ağrı,Taşlıçay
45-49,436,399,835,Ağrı,Taşlıçay
50-54,353,296,649,Ağrı,Taşlıçay
55-59,295,282,577,Ağrı,Taşlıçay
60-64,266,224,490,Ağrı,Taşlıçay
65-69,162,208,370,Ağrı,Taşlıçay
70-74,127,191,318,Ağrı,Taşlıçay
75+,161,239,400,Ağrı,Taşlıçay
18-24,1287,1274,2561,Samsun,Ayvacık
25-29,845,669,1514,Samsun,Ayvacık
30-34,671,561,1232,Samsun,Ayvacık
35-39,619,613,1232,Samsun,Ayvacık
40-44,656,595,1251,Samsun,Ayvacık
45-49,578,560,1138,Samsun,Ayvacık
50-54,662,614,1276,Samsun,Ayvacık
55-59,528,534,1062,Samsun,Ayvacık
60-64,523,507,1030,Samsun,Ayvacık
65-69,351,374,725,Samsun,Ayvacık
70-74,287,312,599,Samsun,Ayvacık
75+,350,506,856,Samsun,Ayvacık
18-24,1137,1082,2219,Samsun,Asarcık
25-29,744,604,1348,Samsun,Asarcık
30-34,578,564,1142,Samsun,Asarcık
35-39,581,579,1160,Samsun,Asarcık
40-44,543,541,1084,Samsun,Asarcık
45-49,428,485,913,Samsun,Asarcık
50-54,446,474,920,Samsun,Asarcık
55-59,318,339,657,Samsun,Asarcık
60-64,334,336,670,Samsun,Asarcık
65-69,262,322,584,Samsun,Asarcık
70-74,202,242,444,Samsun,Asarcık
75+,291,399,690,Samsun,Asarcık
18-24,456,421,877,Denizli,Güney
25-29,280,214,494,Denizli,Güney
30-34,270,232,502,Denizli,Güney
35-39,275,299,574,Denizli,Güney
40-44,330,311,641,Denizli,Güney
45-49,342,351,693,Denizli,Güney
50-54,402,414,816,Denizli,Güney
55-59,393,412,805,Denizli,Güney
60-64,305,360,665,Denizli,Güney
65-69,276,291,567,Denizli,Güney
70-74,188,297,485,Denizli,Güney
75+,389,563,952,Denizli,Güney
18-24,611,580,1191,Sivas,Divriği
25-29,520,436,956,Sivas,Divriği
30-34,506,413,919,Sivas,Divriği
35-39,503,417,920,Sivas,Divriği
40-44,485,392,877,Sivas,Divriği
45-49,416,451,867,Sivas,Divriği
50-54,551,521,1072,Sivas,Divriği
55-59,637,571,1208,Sivas,Divriği
60-64,704,651,1355,Sivas,Divriği
65-69,600,685,1285,Sivas,Divriği
70-74,519,585,1104,Sivas,Divriği
75+,899,1081,1980,Sivas,Divriği
18-24,1453,1448,2901,Nevşehir,Avanos
25-29,989,1013,2002,Nevşehir,Avanos
30-34,1143,1054,2197,Nevşehir,Avanos
35-39,1104,1122,2226,Nevşehir,Avanos
40-44,1066,961,2027,Nevşehir,Avanos
45-49,1054,1035,2089,Nevşehir,Avanos
50-54,1012,1136,2148,Nevşehir,Avanos
55-59,1100,1162,2262,Nevşehir,Avanos
60-64,971,1018,1989,Nevşehir,Avanos
65-69,769,882,1651,Nevşehir,Avanos
70-74,583,770,1353,Nevşehir,Avanos
75+,803,1187,1990,Nevşehir,Avanos
18-24,21548,22191,43739,İzmir,Bornova
25-29,16961,16589,33550,İzmir,Bornova
30-34,17100,16895,33995,İzmir,Bornova
35-39,18953,18663,37616,İzmir,Bornova
40-44,17205,17350,34555,İzmir,Bornova
45-49,15416,15878,31294,İzmir,Bornova
50-54,14276,14017,28293,İzmir,Bornova
55-59,12183,11941,24124,İzmir,Bornova
60-64,9627,9972,19599,İzmir,Bornova
65-69,7030,7715,14745,İzmir,Bornova
70-74,4456,5187,9643,İzmir,Bornova
75+,5206,7767,12973,İzmir,Bornova
18-24,32037,34293,66330,Ankara,Mamak
25-29,25107,25890,50997,Ankara,Mamak
30-34,26372,26137,52509,Ankara,Mamak
35-39,27102,26806,53908,Ankara,Mamak
40-44,24247,24323,48570,Ankara,Mamak
45-49,22068,21958,44026,Ankara,Mamak
50-54,19926,19501,39427,Ankara,Mamak
55-59,16125,15863,31988,Ankara,Mamak
60-64,11541,11773,23314,Ankara,Mamak
65-69,7449,8767,16216,Ankara,Mamak
70-74,4634,6107,10741,Ankara,Mamak
75+,5811,9163,14974,Ankara,Mamak
18-24,844,787,1631,Kilis,Musabeyli
25-29,417,326,743,Kilis,Musabeyli
30-34,347,279,626,Kilis,Musabeyli
35-39,349,382,731,Kilis,Musabeyli
40-44,310,313,623,Kilis,Musabeyli
45-49,327,311,638,Kilis,Musabeyli
50-54,314,343,657,Kilis,Musabeyli
55-59,255,277,532,Kilis,Musabeyli
60-64,260,242,502,Kilis,Musabeyli
65-69,202,251,453,Kilis,Musabeyli
70-74,172,206,378,Kilis,Musabeyli
75+,251,349,600,Kilis,Musabeyli
18-24,5527,5734,11261,Samsun,Canik
25-29,3571,3747,7318,Samsun,Canik
30-34,3811,3789,7600,Samsun,Canik
35-39,4136,3981,8117,Samsun,Canik
40-44,3762,3608,7370,Samsun,Canik
45-49,3065,3100,6165,Samsun,Canik
50-54,2970,2921,5891,Samsun,Canik
55-59,2424,2327,4751,Samsun,Canik
60-64,1840,1979,3819,Samsun,Canik
65-69,1288,1406,2694,Samsun,Canik
70-74,850,1014,1864,Samsun,Canik
75+,1022,1578,2600,Samsun,Canik
18-24,414,411,825,Erzurum,Uzundere
25-29,284,246,530,Erzurum,Uzundere
30-34,289,228,517,Erzurum,Uzundere
35-39,284,214,498,Erzurum,Uzundere
40-44,235,214,449,Erzurum,Uzundere
45-49,253,233,486,Erzurum,Uzundere
50-54,262,271,533,Erzurum,Uzundere
55-59,257,272,529,Erzurum,Uzundere
60-64,274,366,640,Erzurum,Uzundere
65-69,203,254,457,Erzurum,Uzundere
70-74,198,220,418,Erzurum,Uzundere
75+,375,388,763,Erzurum,Uzundere
18-24,843,841,1684,Düzce,Gümüşova
25-29,554,521,1075,Düzce,Gümüşova
30-34,521,508,1029,Düzce,Gümüşova
35-39,600,538,1138,Düzce,Gümüşova
40-44,577,552,1129,Düzce,Gümüşova
45-49,507,557,1064,Düzce,Gümüşova
50-54,517,498,1015,Düzce,Gümüşova
55-59,496,450,946,Düzce,Gümüşova
60-64,385,415,800,Düzce,Gümüşova
65-69,311,329,640,Düzce,Gümüşova
70-74,197,220,417,Düzce,Gümüşova
75+,254,374,628,Düzce,Gümüşova
18-24,2156,2229,4385,Muğla,Ortaca
25-29,1456,1469,2925,Muğla,Ortaca
30-34,1565,1814,3379,Muğla,Ortaca
35-39,1965,1919,3884,Muğla,Ortaca
40-44,1989,2043,4032,Muğla,Ortaca
45-49,2009,1889,3898,Muğla,Ortaca
50-54,1824,1731,3555,Muğla,Ortaca
55-59,1604,1505,3109,Muğla,Ortaca
60-64,1330,1276,2606,Muğla,Ortaca
65-69,938,948,1886,Muğla,Ortaca
70-74,589,602,1191,Muğla,Ortaca
75+,792,1024,1816,Muğla,Ortaca
18-24,4885,5424,10309,Ankara,Çubuk
25-29,3167,3040,6207,Ankara,Çubuk
30-34,3049,3206,6255,Ankara,Çubuk
35-39,3408,3417,6825,Ankara,Çubuk
40-44,3282,3264,6546,Ankara,Çubuk
45-49,3057,2921,5978,Ankara,Çubuk
50-54,2703,2542,5245,Ankara,Çubuk
55-59,2349,2220,4569,Ankara,Çubuk
60-64,1864,1774,3638,Ankara,Çubuk
65-69,1347,1433,2780,Ankara,Çubuk
70-74,910,1044,1954,Ankara,Çubuk
75+,1233,1628,2861,Ankara,Çubuk
18-24,425,287,712,Tunceli,Mazgirt
25-29,341,194,535,Tunceli,Mazgirt
30-34,291,180,471,Tunceli,Mazgirt
35-39,297,207,504,Tunceli,Mazgirt
40-44,243,210,453,Tunceli,Mazgirt
45-49,281,236,517,Tunceli,Mazgirt
50-54,260,265,525,Tunceli,Mazgirt
55-59,271,293,564,Tunceli,Mazgirt
60-64,285,287,572,Tunceli,Mazgirt
65-69,210,262,472,Tunceli,Mazgirt
70-74,182,258,440,Tunceli,Mazgirt
75+,441,512,953,Tunceli,Mazgirt
18-24,506,536,1042,Bayburt,Demirözü
25-29,248,251,499,Bayburt,Demirözü
30-34,251,202,453,Bayburt,Demirözü
35-39,220,218,438,Bayburt,Demirözü
40-44,241,223,464,Bayburt,Demirözü
45-49,234,237,471,Bayburt,Demirözü
50-54,262,249,511,Bayburt,Demirözü
55-59,224,219,443,Bayburt,Demirözü
60-64,235,221,456,Bayburt,Demirözü
65-69,197,214,411,Bayburt,Demirözü
70-74,133,156,289,Bayburt,Demirözü
75+,240,322,562,Bayburt,Demirözü
18-24,701,708,1409,Kırşehir,Çiçekdağı
25-29,396,348,744,Kırşehir,Çiçekdağı
30-34,400,358,758,Kırşehir,Çiçekdağı
35-39,418,381,799,Kırşehir,Çiçekdağı
40-44,417,428,845,Kırşehir,Çiçekdağı
45-49,460,435,895,Kırşehir,Çiçekdağı
50-54,489,524,1013,Kırşehir,Çiçekdağı
55-59,472,551,1023,Kırşehir,Çiçekdağı
60-64,504,529,1033,Kırşehir,Çiçekdağı
65-69,412,472,884,Kırşehir,Çiçekdağı
70-74,284,412,696,Kırşehir,Çiçekdağı
75+,435,612,1047,Kırşehir,Çiçekdağı
18-24,6067,6261,12328,Antalya,Serik
25-29,4332,3976,8308,Antalya,Serik
30-34,4668,4246,8914,Antalya,Serik
35-39,5110,4693,9803,Antalya,Serik
40-44,4904,4378,9282,Antalya,Serik
45-49,4677,4076,8753,Antalya,Serik
50-54,4092,3572,7664,Antalya,Serik
55-59,3340,3230,6570,Antalya,Serik
60-64,2693,2762,5455,Antalya,Serik
65-69,1878,1994,3872,Antalya,Serik
70-74,1267,1461,2728,Antalya,Serik
75+,1733,2294,4027,Antalya,Serik
18-24,2053,2126,4179,Sivas,Şarkışla
25-29,1099,1229,2328,Sivas,Şarkışla
30-34,1373,1242,2615,Sivas,Şarkışla
35-39,1416,1251,2667,Sivas,Şarkışla
40-44,1134,1186,2320,Sivas,Şarkışla
45-49,1099,1080,2179,Sivas,Şarkışla
50-54,1114,1133,2247,Sivas,Şarkışla
55-59,999,1140,2139,Sivas,Şarkışla
60-64,994,1063,2057,Sivas,Şarkışla
65-69,935,946,1881,Sivas,Şarkışla
70-74,650,813,1463,Sivas,Şarkışla
75+,870,1177,2047,Sivas,Şarkışla
18-24,779,806,1585,Rize,Fındıklı
25-29,470,475,945,Rize,Fındıklı
30-34,473,469,942,Rize,Fındıklı
35-39,521,481,1002,Rize,Fındıklı
40-44,552,509,1061,Rize,Fındıklı
45-49,555,585,1140,Rize,Fındıklı
50-54,566,538,1104,Rize,Fındıklı
55-59,577,548,1125,Rize,Fındıklı
60-64,523,523,1046,Rize,Fındıklı
65-69,401,390,791,Rize,Fındıklı
70-74,260,347,607,Rize,Fındıklı
75+,517,832,1349,Rize,Fındıklı
18-24,8429,8612,17041,Manisa,Şehzadeler
25-29,6455,6125,12580,Manisa,Şehzadeler
30-34,6600,6494,13094,Manisa,Şehzadeler
35-39,7027,6714,13741,Manisa,Şehzadeler
40-44,5885,5807,11692,Manisa,Şehzadeler
45-49,5190,5423,10613,Manisa,Şehzadeler
50-54,5002,5052,10054,Manisa,Şehzadeler
55-59,4524,4485,9009,Manisa,Şehzadeler
60-64,3476,3784,7260,Manisa,Şehzadeler
65-69,2574,2944,5518,Manisa,Şehzadeler
70-74,1741,2306,4047,Manisa,Şehzadeler
75+,2130,3460,5590,Manisa,Şehzadeler
18-24,3210,3417,6627,Mersin,Mut
25-29,1920,1854,3774,Mersin,Mut
30-34,2056,1977,4033,Mersin,Mut
35-39,2268,2137,4405,Mersin,Mut
40-44,2256,2136,4392,Mersin,Mut
45-49,2393,2261,4654,Mersin,Mut
50-54,2043,2165,4208,Mersin,Mut
55-59,1794,1801,3595,Mersin,Mut
60-64,1435,1479,2914,Mersin,Mut
65-69,1073,1324,2397,Mersin,Mut
70-74,917,1088,2005,Mersin,Mut
75+,1488,1911,3399,Mersin,Mut
18-24,1011,958,1969,Sivas,Zara
25-29,652,551,1203,Sivas,Zara
30-34,645,609,1254,Sivas,Zara
35-39,661,607,1268,Sivas,Zara
40-44,626,563,1189,Sivas,Zara
45-49,586,539,1125,Sivas,Zara
50-54,641,665,1306,Sivas,Zara
55-59,775,832,1607,Sivas,Zara
60-64,907,909,1816,Sivas,Zara
65-69,875,855,1730,Sivas,Zara
70-74,680,743,1423,Sivas,Zara
75+,950,1096,2046,Sivas,Zara
18-24,42804,44524,87328,Adana,Seyhan
25-29,29764,30464,60228,Adana,Seyhan
30-34,31084,31134,62218,Adana,Seyhan
35-39,33182,32527,65709,Adana,Seyhan
40-44,28090,27587,55677,Adana,Seyhan
45-49,23243,23855,47098,Adana,Seyhan
50-54,21065,21223,42288,Adana,Seyhan
55-59,17672,18623,36295,Adana,Seyhan
60-64,14529,15841,30370,Adana,Seyhan
65-69,10829,12212,23041,Adana,Seyhan
70-74,6505,8282,14787,Adana,Seyhan
75+,7353,12053,19406,Adana,Seyhan
18-24,252,251,503,Kütahya,Çavdarhisar
25-29,146,126,272,Kütahya,Çavdarhisar
30-34,150,150,300,Kütahya,Çavdarhisar
35-39,176,163,339,Kütahya,Çavdarhisar
40-44,204,207,411,Kütahya,Çavdarhisar
45-49,210,211,421,Kütahya,Çavdarhisar
50-54,231,247,478,Kütahya,Çavdarhisar
55-59,250,267,517,Kütahya,Çavdarhisar
60-64,264,301,565,Kütahya,Çavdarhisar
65-69,248,282,530,Kütahya,Çavdarhisar
70-74,145,263,408,Kütahya,Çavdarhisar
75+,275,441,716,Kütahya,Çavdarhisar
18-24,1433,1449,2882,Konya,Sarayönü
25-29,950,836,1786,Konya,Sarayönü
30-34,985,846,1831,Konya,Sarayönü
35-39,918,840,1758,Konya,Sarayönü
40-44,799,720,1519,Konya,Sarayönü
45-49,771,819,1590,Konya,Sarayönü
50-54,868,806,1674,Konya,Sarayönü
55-59,739,803,1542,Konya,Sarayönü
60-64,627,671,1298,Konya,Sarayönü
65-69,521,653,1174,Konya,Sarayönü
70-74,359,493,852,Konya,Sarayönü
75+,438,704,1142,Konya,Sarayönü
18-24,831,804,1635,Bolu,Mudurnu
25-29,586,481,1067,Bolu,Mudurnu
30-34,613,519,1132,Bolu,Mudurnu
35-39,583,510,1093,Bolu,Mudurnu
40-44,574,471,1045,Bolu,Mudurnu
45-49,574,651,1225,Bolu,Mudurnu
50-54,663,647,1310,Bolu,Mudurnu
55-59,703,713,1416,Bolu,Mudurnu
60-64,673,704,1377,Bolu,Mudurnu
65-69,546,600,1146,Bolu,Mudurnu
70-74,411,525,936,Bolu,Mudurnu
75+,760,1005,1765,Bolu,Mudurnu
18-24,88,84,172,Bilecik,Yenipazar
25-29,71,66,137,Bilecik,Yenipazar
30-34,77,53,130,Bilecik,Yenipazar
35-39,66,67,133,Bilecik,Yenipazar
40-44,70,64,134,Bilecik,Yenipazar
45-49,70,82,152,Bilecik,Yenipazar
50-54,110,104,214,Bilecik,Yenipazar
55-59,144,140,284,Bilecik,Yenipazar
60-64,125,155,280,Bilecik,Yenipazar
65-69,150,171,321,Bilecik,Yenipazar
70-74,95,95,190,Bilecik,Yenipazar
75+,183,254,437,Bilecik,Yenipazar
18-24,244,213,457,Rize,İkizdere
25-29,184,142,326,Rize,İkizdere
30-34,159,110,269,Rize,İkizdere
35-39,180,118,298,Rize,İkizdere
40-44,185,125,310,Rize,İkizdere
45-49,191,146,337,Rize,İkizdere
50-54,252,171,423,Rize,İkizdere
55-59,253,241,494,Rize,İkizdere
60-64,299,242,541,Rize,İkizdere
65-69,228,240,468,Rize,İkizdere
70-74,161,211,372,Rize,İkizdere
75+,247,519,766,Rize,İkizdere
18-24,5424,4806,10230,Van,Özalp
25-29,2671,2473,5144,Van,Özalp
30-34,2046,1882,3928,Van,Özalp
35-39,1774,1727,3501,Van,Özalp
40-44,1316,1248,2564,Van,Özalp
45-49,1216,1124,2340,Van,Özalp
50-54,1053,1072,2125,Van,Özalp
55-59,919,881,1800,Van,Özalp
60-64,550,692,1242,Van,Özalp
65-69,455,528,983,Van,Özalp
70-74,270,317,587,Van,Özalp
75+,321,456,777,Van,Özalp
18-24,95,117,212,Elazığ,Ağın
25-29,64,60,124,Elazığ,Ağın
30-34,72,53,125,Elazığ,Ağın
35-39,48,47,95,Elazığ,Ağın
40-44,59,70,129,Elazığ,Ağın
45-49,74,83,157,Elazığ,Ağın
50-54,65,71,136,Elazığ,Ağın
55-59,79,86,165,Elazığ,Ağın
60-64,104,114,218,Elazığ,Ağın
65-69,111,124,235,Elazığ,Ağın
70-74,103,106,209,Elazığ,Ağın
75+,198,282,480,Elazığ,Ağın
18-24,101,72,173,Çanakkale,Bozcaada
25-29,119,96,215,Çanakkale,Bozcaada
30-34,135,91,226,Çanakkale,Bozcaada
35-39,123,110,233,Çanakkale,Bozcaada
40-44,136,97,233,Çanakkale,Bozcaada
45-49,131,99,230,Çanakkale,Bozcaada
50-54,119,118,237,Çanakkale,Bozcaada
55-59,136,115,251,Çanakkale,Bozcaada
60-64,102,111,213,Çanakkale,Bozcaada
65-69,86,71,157,Çanakkale,Bozcaada
70-74,54,61,115,Çanakkale,Bozcaada
75+,75,90,165,Çanakkale,Bozcaada
18-24,5356,5884,11240,Şanlıurfa,Ceylanpınar
25-29,3322,3402,6724,Şanlıurfa,Ceylanpınar
30-34,2885,2852,5737,Şanlıurfa,Ceylanpınar
35-39,2538,2591,5129,Şanlıurfa,Ceylanpınar
40-44,2057,2141,4198,Şanlıurfa,Ceylanpınar
45-49,1548,1534,3082,Şanlıurfa,Ceylanpınar
50-54,1497,1414,2911,Şanlıurfa,Ceylanpınar
55-59,904,987,1891,Şanlıurfa,Ceylanpınar
60-64,642,717,1359,Şanlıurfa,Ceylanpınar
65-69,477,585,1062,Şanlıurfa,Ceylanpınar
70-74,346,456,802,Şanlıurfa,Ceylanpınar
75+,448,740,1188,Şanlıurfa,Ceylanpınar
18-24,1074,1093,2167,Sivas,Gürün
25-29,587,567,1154,Sivas,Gürün
30-34,562,510,1072,Sivas,Gürün
35-39,515,506,1021,Sivas,Gürün
40-44,516,559,1075,Sivas,Gürün
45-49,625,577,1202,Sivas,Gürün
50-54,584,589,1173,Sivas,Gürün
55-59,555,488,1043,Sivas,Gürün
60-64,558,531,1089,Sivas,Gürün
65-69,434,502,936,Sivas,Gürün
70-74,413,493,906,Sivas,Gürün
75+,629,787,1416,Sivas,Gürün
18-24,1341,1289,2630,Kahramanmaraş,Çağlayancerit
25-29,764,658,1422,Kahramanmaraş,Çağlayancerit
30-34,867,684,1551,Kahramanmaraş,Çağlayancerit
35-39,830,799,1629,Kahramanmaraş,Çağlayancerit
40-44,725,695,1420,Kahramanmaraş,Çağlayancerit
45-49,706,727,1433,Kahramanmaraş,Çağlayancerit
50-54,592,610,1202,Kahramanmaraş,Çağlayancerit
55-59,527,545,1072,Kahramanmaraş,Çağlayancerit
60-64,520,493,1013,Kahramanmaraş,Çağlayancerit
65-69,371,437,808,Kahramanmaraş,Çağlayancerit
70-74,345,344,689,Kahramanmaraş,Çağlayancerit
75+,466,580,1046,Kahramanmaraş,Çağlayancerit
18-24,1628,1714,3342,Kastamonu,Taşköprü
25-29,1032,987,2019,Kastamonu,Taşköprü
30-34,1152,1125,2277,Kastamonu,Taşköprü
35-39,1324,1313,2637,Kastamonu,Taşköprü
40-44,1165,1208,2373,Kastamonu,Taşköprü
45-49,1093,1152,2245,Kastamonu,Taşköprü
50-54,1323,1220,2543,Kastamonu,Taşköprü
55-59,1360,1515,2875,Kastamonu,Taşköprü
60-64,1401,1529,2930,Kastamonu,Taşköprü
65-69,1111,1220,2331,Kastamonu,Taşköprü
70-74,841,1043,1884,Kastamonu,Taşköprü
75+,1264,1859,3123,Kastamonu,Taşköprü
18-24,328,297,625,Bilecik,Gölpazarı
25-29,262,196,458,Bilecik,Gölpazarı
30-34,259,197,456,Bilecik,Gölpazarı
35-39,262,201,463,Bilecik,Gölpazarı
40-44,247,212,459,Bilecik,Gölpazarı
45-49,275,299,574,Bilecik,Gölpazarı
50-54,337,341,678,Bilecik,Gölpazarı
55-59,434,439,873,Bilecik,Gölpazarı
60-64,376,393,769,Bilecik,Gölpazarı
65-69,381,358,739,Bilecik,Gölpazarı
70-74,216,318,534,Bilecik,Gölpazarı
75+,549,804,1353,Bilecik,Gölpazarı
18-24,1466,1513,2979,Malatya,Darende
25-29,728,795,1523,Malatya,Darende
30-34,817,815,1632,Malatya,Darende
35-39,914,808,1722,Malatya,Darende
40-44,804,803,1607,Malatya,Darende
45-49,751,786,1537,Malatya,Darende
50-54,787,728,1515,Malatya,Darende
55-59,763,700,1463,Malatya,Darende
60-64,726,708,1434,Malatya,Darende
65-69,631,688,1319,Malatya,Darende
70-74,452,592,1044,Malatya,Darende
75+,619,920,1539,Malatya,Darende
18-24,2256,2336,4592,Rize,Çayeli
25-29,1335,1352,2687,Rize,Çayeli
30-34,1363,1227,2590,Rize,Çayeli
35-39,1417,1364,2781,Rize,Çayeli
40-44,1394,1351,2745,Rize,Çayeli
45-49,1590,1562,3152,Rize,Çayeli
50-54,1631,1479,3110,Rize,Çayeli
55-59,1496,1348,2844,Rize,Çayeli
60-64,1227,1347,2574,Rize,Çayeli
65-69,890,971,1861,Rize,Çayeli
70-74,642,779,1421,Rize,Çayeli
75+,940,1741,2681,Rize,Çayeli
18-24,601,684,1285,Konya,Hüyük
25-29,354,342,696,Konya,Hüyük
30-34,414,358,772,Konya,Hüyük
35-39,412,365,777,Konya,Hüyük
40-44,388,448,836,Konya,Hüyük
45-49,481,474,955,Konya,Hüyük
50-54,511,546,1057,Konya,Hüyük
55-59,574,652,1226,Konya,Hüyük
60-64,590,676,1266,Konya,Hüyük
65-69,515,632,1147,Konya,Hüyük
70-74,432,517,949,Konya,Hüyük
75+,688,1016,1704,Konya,Hüyük
18-24,19645,20154,39799,Kocaeli,Gebze
25-29,16016,16543,32559,Kocaeli,Gebze
30-34,17934,17079,35013,Kocaeli,Gebze
35-39,18194,16931,35125,Kocaeli,Gebze
40-44,15221,13854,29075,Kocaeli,Gebze
45-49,12288,11380,23668,Kocaeli,Gebze
50-54,10189,9480,19669,Kocaeli,Gebze
55-59,8031,7563,15594,Kocaeli,Gebze
60-64,5691,5761,11452,Kocaeli,Gebze
65-69,3621,3978,7599,Kocaeli,Gebze
70-74,2161,2439,4600,Kocaeli,Gebze
75+,2267,3368,5635,Kocaeli,Gebze
18-24,1173,1097,2270,Mardin,Yeşilli
25-29,642,511,1153,Mardin,Yeşilli
30-34,489,391,880,Mardin,Yeşilli
35-39,406,364,770,Mardin,Yeşilli
40-44,319,335,654,Mardin,Yeşilli
45-49,319,290,609,Mardin,Yeşilli
50-54,261,216,477,Mardin,Yeşilli
55-59,198,215,413,Mardin,Yeşilli
60-64,146,179,325,Mardin,Yeşilli
65-69,127,155,282,Mardin,Yeşilli
70-74,108,136,244,Mardin,Yeşilli
75+,169,198,367,Mardin,Yeşilli
18-24,338,342,680,Kayseri,Akkışla
25-29,201,151,352,Kayseri,Akkışla
30-34,180,113,293,Kayseri,Akkışla
35-39,164,135,299,Kayseri,Akkışla
40-44,172,181,353,Kayseri,Akkışla
45-49,190,218,408,Kayseri,Akkışla
50-54,244,232,476,Kayseri,Akkışla
55-59,238,250,488,Kayseri,Akkışla
60-64,238,258,496,Kayseri,Akkışla
65-69,198,204,402,Kayseri,Akkışla
70-74,123,163,286,Kayseri,Akkışla
75+,220,310,530,Kayseri,Akkışla
18-24,1361,1317,2678,Amasya,Taşova
25-29,673,683,1356,Amasya,Taşova
30-34,776,732,1508,Amasya,Taşova
35-39,774,840,1614,Amasya,Taşova
40-44,820,772,1592,Amasya,Taşova
45-49,855,896,1751,Amasya,Taşova
50-54,1129,1162,2291,Amasya,Taşova
55-59,1184,1272,2456,Amasya,Taşova
60-64,1124,1295,2419,Amasya,Taşova
65-69,999,1188,2187,Amasya,Taşova
70-74,823,1071,1894,Amasya,Taşova
75+,1368,1780,3148,Amasya,Taşova
18-24,359,350,709,Çankırı,Kızılırmak
25-29,194,172,366,Çankırı,Kızılırmak
30-34,214,166,380,Çankırı,Kızılırmak
35-39,200,185,385,Çankırı,Kızılırmak
40-44,152,166,318,Çankırı,Kızılırmak
45-49,239,238,477,Çankırı,Kızılırmak
50-54,276,284,560,Çankırı,Kızılırmak
55-59,276,287,563,Çankırı,Kızılırmak
60-64,234,259,493,Çankırı,Kızılırmak
65-69,214,235,449,Çankırı,Kızılırmak
70-74,159,215,374,Çankırı,Kızılırmak
75+,283,389,672,Çankırı,Kızılırmak
18-24,8113,8279,16392,Çanakkale,Çanakkale Merkez
25-29,5974,5805,11779,Çanakkale,Çanakkale Merkez
30-34,6207,6290,12497,Çanakkale,Çanakkale Merkez
35-39,6678,7089,13767,Çanakkale,Çanakkale Merkez
40-44,6003,6452,12455,Çanakkale,Çanakkale Merkez
45-49,5703,6177,11880,Çanakkale,Çanakkale Merkez
50-54,5424,5696,11120,Çanakkale,Çanakkale Merkez
55-59,5014,5291,10305,Çanakkale,Çanakkale Merkez
60-64,4406,4536,8942,Çanakkale,Çanakkale Merkez
65-69,3386,3404,6790,Çanakkale,Çanakkale Merkez
70-74,2131,2374,4505,Çanakkale,Çanakkale Merkez
75+,2523,3559,6082,Çanakkale,Çanakkale Merkez
18-24,10849,11143,21992,Antalya,Manavgat
25-29,8002,8130,16132,Antalya,Manavgat
30-34,9721,9082,18803,Antalya,Manavgat
35-39,10967,9820,20787,Antalya,Manavgat
40-44,10049,8753,18802,Antalya,Manavgat
45-49,9004,7675,16679,Antalya,Manavgat
50-54,7210,6124,13334,Antalya,Manavgat
55-59,5596,5121,10717,Antalya,Manavgat
60-64,3971,3718,7689,Antalya,Manavgat
65-69,2475,2586,5061,Antalya,Manavgat
70-74,1658,1930,3588,Antalya,Manavgat
75+,2389,3148,5537,Antalya,Manavgat
18-24,993,933,1926,Sinop,Ayancık
25-29,625,555,1180,Sinop,Ayancık
30-34,664,633,1297,Sinop,Ayancık
35-39,666,630,1296,Sinop,Ayancık
40-44,603,613,1216,Sinop,Ayancık
45-49,623,658,1281,Sinop,Ayancık
50-54,755,798,1553,Sinop,Ayancık
55-59,897,1014,1911,Sinop,Ayancık
60-64,1052,944,1996,Sinop,Ayancık
65-69,884,863,1747,Sinop,Ayancık
70-74,553,540,1093,Sinop,Ayancık
75+,951,1309,2260,Sinop,Ayancık
18-24,5822,6186,12008,Bitlis,Tatvan
25-29,4014,4160,8174,Bitlis,Tatvan
30-34,3727,3363,7090,Bitlis,Tatvan
35-39,3326,3099,6425,Bitlis,Tatvan
40-44,2520,2253,4773,Bitlis,Tatvan
45-49,2113,1804,3917,Bitlis,Tatvan
50-54,1744,1430,3174,Bitlis,Tatvan
55-59,1288,1048,2336,Bitlis,Tatvan
60-64,1054,1126,2180,Bitlis,Tatvan
65-69,734,863,1597,Bitlis,Tatvan
70-74,460,625,1085,Bitlis,Tatvan
75+,596,825,1421,Bitlis,Tatvan
18-24,124,144,268,Çankırı,Korgun
25-29,103,93,196,Çankırı,Korgun
30-34,109,86,195,Çankırı,Korgun
35-39,104,84,188,Çankırı,Korgun
40-44,74,66,140,Çankırı,Korgun
45-49,76,97,173,Çankırı,Korgun
50-54,104,148,252,Çankırı,Korgun
55-59,166,162,328,Çankırı,Korgun
60-64,219,190,409,Çankırı,Korgun
65-69,177,202,379,Çankırı,Korgun
70-74,141,137,278,Çankırı,Korgun
75+,225,297,522,Çankırı,Korgun
18-24,20653,22424,43077,Diyarbakır,Kayapınar
25-29,15197,17071,32268,Diyarbakır,Kayapınar
30-34,14456,15232,29688,Diyarbakır,Kayapınar
35-39,13953,14260,28213,Diyarbakır,Kayapınar
40-44,10934,10576,21510,Diyarbakır,Kayapınar
45-49,8706,8304,17010,Diyarbakır,Kayapınar
50-54,6925,6466,13391,Diyarbakır,Kayapınar
55-59,5131,5053,10184,Diyarbakır,Kayapınar
60-64,3729,3537,7266,Diyarbakır,Kayapınar
65-69,2507,2688,5195,Diyarbakır,Kayapınar
70-74,1406,1744,3150,Diyarbakır,Kayapınar
75+,1585,2422,4007,Diyarbakır,Kayapınar
18-24,449,415,864,Nevşehir,Hacıbektaş
25-29,253,265,518,Nevşehir,Hacıbektaş
30-34,285,251,536,Nevşehir,Hacıbektaş
35-39,309,313,622,Nevşehir,Hacıbektaş
40-44,302,271,573,Nevşehir,Hacıbektaş
45-49,343,353,696,Nevşehir,Hacıbektaş
50-54,412,446,858,Nevşehir,Hacıbektaş
55-59,446,488,934,Nevşehir,Hacıbektaş
60-64,457,460,917,Nevşehir,Hacıbektaş
65-69,407,441,848,Nevşehir,Hacıbektaş
70-74,288,357,645,Nevşehir,Hacıbektaş
75+,473,684,1157,Nevşehir,Hacıbektaş
18-24,1289,1290,2579,Tekirdağ,Muratlı
25-29,1020,992,2012,Tekirdağ,Muratlı
30-34,1073,1001,2074,Tekirdağ,Muratlı
35-39,1239,1111,2350,Tekirdağ,Muratlı
40-44,1086,966,2052,Tekirdağ,Muratlı
45-49,1012,939,1951,Tekirdağ,Muratlı
50-54,920,959,1879,Tekirdağ,Muratlı
55-59,1000,965,1965,Tekirdağ,Muratlı
60-64,871,899,1770,Tekirdağ,Muratlı
65-69,592,611,1203,Tekirdağ,Muratlı
70-74,307,409,716,Tekirdağ,Muratlı
75+,458,753,1211,Tekirdağ,Muratlı
18-24,13357,14416,27773,Bursa,İnegöl
25-29,9640,9668,19308,Bursa,İnegöl
30-34,10363,9941,20304,Bursa,İnegöl
35-39,10871,10398,21269,Bursa,İnegöl
40-44,9663,9251,18914,Bursa,İnegöl
45-49,8663,8348,17011,Bursa,İnegöl
50-54,7541,7063,14604,Bursa,İnegöl
55-59,6199,5949,12148,Bursa,İnegöl
60-64,4866,5029,9895,Bursa,İnegöl
65-69,3266,3746,7012,Bursa,İnegöl
70-74,2261,2759,5020,Bursa,İnegöl
75+,2833,4406,7239,Bursa,İnegöl
18-24,14707,15450,30157,Osmaniye,Osmaniye Merkez
25-29,8828,9593,18421,Osmaniye,Osmaniye Merkez
30-34,9627,9789,19416,Osmaniye,Osmaniye Merkez
35-39,10153,10482,20635,Osmaniye,Osmaniye Merkez
40-44,8652,8687,17339,Osmaniye,Osmaniye Merkez
45-49,7603,7739,15342,Osmaniye,Osmaniye Merkez
50-54,6779,6562,13341,Osmaniye,Osmaniye Merkez
55-59,5835,5719,11554,Osmaniye,Osmaniye Merkez
60-64,4673,4639,9312,Osmaniye,Osmaniye Merkez
65-69,3566,3635,7201,Osmaniye,Osmaniye Merkez
70-74,2130,2342,4472,Osmaniye,Osmaniye Merkez
75+,2338,3356,5694,Osmaniye,Osmaniye Merkez
18-24,1577,1479,3056,Balıkesir,İvrindi
25-29,839,760,1599,Balıkesir,İvrindi
30-34,866,822,1688,Balıkesir,İvrindi
35-39,972,971,1943,Balıkesir,İvrindi
40-44,1166,1078,2244,Balıkesir,İvrindi
45-49,1150,1088,2238,Balıkesir,İvrindi
50-54,1225,1201,2426,Balıkesir,İvrindi
55-59,1210,1201,2411,Balıkesir,İvrindi
60-64,1058,1176,2234,Balıkesir,İvrindi
65-69,893,1069,1962,Balıkesir,İvrindi
70-74,747,830,1577,Balıkesir,İvrindi
75+,1238,1685,2923,Balıkesir,İvrindi
18-24,42293,45414,87707,Gaziantep,Şehitkamil
25-29,28382,29011,57393,Gaziantep,Şehitkamil
30-34,29121,29016,58137,Gaziantep,Şehitkamil
35-39,28621,27773,56394,Gaziantep,Şehitkamil
40-44,23702,22845,46547,Gaziantep,Şehitkamil
45-49,18794,17912,36706,Gaziantep,Şehitkamil
50-54,15412,14714,30126,Gaziantep,Şehitkamil
55-59,11780,11753,23533,Gaziantep,Şehitkamil
60-64,8686,8783,17469,Gaziantep,Şehitkamil
65-69,6624,6885,13509,Gaziantep,Şehitkamil
70-74,4371,4947,9318,Gaziantep,Şehitkamil
75+,4795,7102,11897,Gaziantep,Şehitkamil
18-24,2789,3058,5847,Bursa,Kestel
25-29,2299,2365,4664,Bursa,Kestel
30-34,2492,2495,4987,Bursa,Kestel
35-39,2700,2509,5209,Bursa,Kestel
40-44,2269,2205,4474,Bursa,Kestel
45-49,2103,2084,4187,Bursa,Kestel
50-54,1969,1966,3935,Bursa,Kestel
55-59,1807,1825,3632,Bursa,Kestel
60-64,1491,1492,2983,Bursa,Kestel
65-69,1022,1082,2104,Bursa,Kestel
70-74,629,763,1392,Bursa,Kestel
75+,868,1334,2202,Bursa,Kestel
18-24,7870,8063,15933,Diyarbakır,Sur
25-29,4947,4539,9486,Diyarbakır,Sur
30-34,3919,3590,7509,Diyarbakır,Sur
35-39,3616,3637,7253,Diyarbakır,Sur
40-44,2886,2921,5807,Diyarbakır,Sur
45-49,2600,2621,5221,Diyarbakır,Sur
50-54,2158,2170,4328,Diyarbakır,Sur
55-59,1483,1550,3033,Diyarbakır,Sur
60-64,1162,1173,2335,Diyarbakır,Sur
65-69,810,1053,1863,Diyarbakır,Sur
70-74,598,819,1417,Diyarbakır,Sur
75+,780,1393,2173,Diyarbakır,Sur
18-24,2711,2766,5477,Kütahya,Simav
25-29,1607,1583,3190,Kütahya,Simav
30-34,1830,1695,3525,Kütahya,Simav
35-39,1908,1942,3850,Kütahya,Simav
40-44,2025,2106,4131,Kütahya,Simav
45-49,2075,2251,4326,Kütahya,Simav
50-54,2172,2328,4500,Kütahya,Simav
55-59,2416,2618,5034,Kütahya,Simav
60-64,2249,2475,4724,Kütahya,Simav
65-69,1823,2053,3876,Kütahya,Simav
70-74,1244,1622,2866,Kütahya,Simav
75+,2097,2839,4936,Kütahya,Simav
18-24,304,281,585,Yozgat,Yenifakılı
25-29,153,150,303,Yozgat,Yenifakılı
30-34,143,148,291,Yozgat,Yenifakılı
35-39,155,154,309,Yozgat,Yenifakılı
40-44,171,169,340,Yozgat,Yenifakılı
45-49,188,158,346,Yozgat,Yenifakılı
50-54,202,194,396,Yozgat,Yenifakılı
55-59,208,210,418,Yozgat,Yenifakılı
60-64,199,177,376,Yozgat,Yenifakılı
65-69,142,159,301,Yozgat,Yenifakılı
70-74,93,162,255,Yozgat,Yenifakılı
75+,137,255,392,Yozgat,Yenifakılı
18-24,350,343,693,Denizli,Babadağ
25-29,215,166,381,Denizli,Babadağ
30-34,235,200,435,Denizli,Babadağ
35-39,258,239,497,Denizli,Babadağ
40-44,250,198,448,Denizli,Babadağ
45-49,233,224,457,Denizli,Babadağ
50-54,205,177,382,Denizli,Babadağ
55-59,193,236,429,Denizli,Babadağ
60-64,182,142,324,Denizli,Babadağ
65-69,133,154,287,Denizli,Babadağ
70-74,115,148,263,Denizli,Babadağ
75+,156,241,397,Denizli,Babadağ
18-24,6175,6139,12314,Tekirdağ,Kapaklı
25-29,5227,4875,10102,Tekirdağ,Kapaklı
30-34,5781,5295,11076,Tekirdağ,Kapaklı
35-39,6034,5373,11407,Tekirdağ,Kapaklı
40-44,4714,4093,8807,Tekirdağ,Kapaklı
45-49,3576,3156,6732,Tekirdağ,Kapaklı
50-54,2836,2561,5397,Tekirdağ,Kapaklı
55-59,2143,1994,4137,Tekirdağ,Kapaklı
60-64,1473,1475,2948,Tekirdağ,Kapaklı
65-69,964,987,1951,Tekirdağ,Kapaklı
70-74,450,611,1061,Tekirdağ,Kapaklı
75+,562,921,1483,Tekirdağ,Kapaklı
18-24,332,340,672,Ardahan,Posof
25-29,253,229,482,Ardahan,Posof
30-34,226,168,394,Ardahan,Posof
35-39,192,191,383,Ardahan,Posof
40-44,206,165,371,Ardahan,Posof
45-49,187,203,390,Ardahan,Posof
50-54,225,269,494,Ardahan,Posof
55-59,261,248,509,Ardahan,Posof
60-64,287,262,549,Ardahan,Posof
65-69,236,197,433,Ardahan,Posof
70-74,120,156,276,Ardahan,Posof
75+,189,242,431,Ardahan,Posof
18-24,7507,8054,15561,Manisa,Akhisar
25-29,5723,5404,11127,Manisa,Akhisar
30-34,6078,5805,11883,Manisa,Akhisar
35-39,6478,6453,12931,Manisa,Akhisar
40-44,6219,6163,12382,Manisa,Akhisar
45-49,5857,5993,11850,Manisa,Akhisar
50-54,5785,5911,11696,Manisa,Akhisar
55-59,5645,5678,11323,Manisa,Akhisar
60-64,4874,4869,9743,Manisa,Akhisar
65-69,3692,3960,7652,Manisa,Akhisar
70-74,2385,3039,5424,Manisa,Akhisar
75+,3339,5171,8510,Manisa,Akhisar
18-24,9126,9772,18898,Şırnak,Silopi
25-29,7082,5782,12864,Şırnak,Silopi
30-34,4693,4142,8835,Şırnak,Silopi
35-39,3671,3843,7514,Şırnak,Silopi
40-44,2581,2670,5251,Şırnak,Silopi
45-49,2120,2169,4289,Şırnak,Silopi
50-54,1689,1607,3296,Şırnak,Silopi
55-59,1062,963,2025,Şırnak,Silopi
60-64,853,854,1707,Şırnak,Silopi
65-69,542,739,1281,Şırnak,Silopi
70-74,342,447,789,Şırnak,Silopi
75+,557,955,1512,Şırnak,Silopi
18-24,218,185,403,Karaman,Kazımkarabekir
25-29,122,109,231,Karaman,Kazımkarabekir
30-34,138,126,264,Karaman,Kazımkarabekir
35-39,130,99,229,Karaman,Kazımkarabekir
40-44,115,118,233,Karaman,Kazımkarabekir
45-49,125,117,242,Karaman,Kazımkarabekir
50-54,107,125,232,Karaman,Kazımkarabekir
55-59,126,138,264,Karaman,Kazımkarabekir
60-64,121,124,245,Karaman,Kazımkarabekir
65-69,98,108,206,Karaman,Kazımkarabekir
70-74,62,92,154,Karaman,Kazımkarabekir
75+,134,179,313,Karaman,Kazımkarabekir
18-24,943,1001,1944,Kastamonu,İnebolu
25-29,668,668,1336,Kastamonu,İnebolu
30-34,655,642,1297,Kastamonu,İnebolu
35-39,642,646,1288,Kastamonu,İnebolu
40-44,599,576,1175,Kastamonu,İnebolu
45-49,573,603,1176,Kastamonu,İnebolu
50-54,572,660,1232,Kastamonu,İnebolu
55-59,722,714,1436,Kastamonu,İnebolu
60-64,595,723,1318,Kastamonu,İnebolu
65-69,612,622,1234,Kastamonu,İnebolu
70-74,410,501,911,Kastamonu,İnebolu
75+,642,907,1549,Kastamonu,İnebolu
18-24,444,408,852,Malatya,Arapgir
25-29,267,240,507,Malatya,Arapgir
30-34,314,291,605,Malatya,Arapgir
35-39,313,289,602,Malatya,Arapgir
40-44,314,275,589,Malatya,Arapgir
45-49,338,302,640,Malatya,Arapgir
50-54,289,301,590,Malatya,Arapgir
55-59,316,304,620,Malatya,Arapgir
60-64,350,339,689,Malatya,Arapgir
65-69,309,351,660,Malatya,Arapgir
70-74,271,349,620,Malatya,Arapgir
75+,557,731,1288,Malatya,Arapgir
18-24,2213,2304,4517,Batman,Sason
25-29,1522,1294,2816,Batman,Sason
30-34,924,868,1792,Batman,Sason
35-39,836,857,1693,Batman,Sason
40-44,646,558,1204,Batman,Sason
45-49,716,567,1283,Batman,Sason
50-54,560,479,1039,Batman,Sason
55-59,356,314,670,Batman,Sason
60-64,245,343,588,Batman,Sason
65-69,213,328,541,Batman,Sason
70-74,165,246,411,Batman,Sason
75+,229,423,652,Batman,Sason
18-24,4759,4748,9507,Aydın,Kuşadası
25-29,3446,3406,6852,Aydın,Kuşadası
30-34,3739,3771,7510,Aydın,Kuşadası
35-39,4400,4387,8787,Aydın,Kuşadası
40-44,4142,4254,8396,Aydın,Kuşadası
45-49,4034,4077,8111,Aydın,Kuşadası
50-54,3969,4019,7988,Aydın,Kuşadası
55-59,3854,4036,7890,Aydın,Kuşadası
60-64,3398,3542,6940,Aydın,Kuşadası
65-69,2787,2793,5580,Aydın,Kuşadası
70-74,1970,1863,3833,Aydın,Kuşadası
75+,2019,2238,4257,Aydın,Kuşadası
18-24,9025,8567,17592,Ağrı,Patnos
25-29,5510,4737,10247,Ağrı,Patnos
30-34,3844,3192,7036,Ağrı,Patnos
35-39,3386,3137,6523,Ağrı,Patnos
40-44,2331,2031,4362,Ağrı,Patnos
45-49,2237,1812,4049,Ağrı,Patnos
50-54,1902,1638,3540,Ağrı,Patnos
55-59,1529,1400,2929,Ağrı,Patnos
60-64,1236,1451,2687,Ağrı,Patnos
65-69,697,1058,1755,Ağrı,Patnos
70-74,524,612,1136,Ağrı,Patnos
75+,583,948,1531,Ağrı,Patnos
18-24,1226,1308,2534,Osmaniye,Bahçe
25-29,713,682,1395,Osmaniye,Bahçe
30-34,739,715,1454,Osmaniye,Bahçe
35-39,784,726,1510,Osmaniye,Bahçe
40-44,685,699,1384,Osmaniye,Bahçe
45-49,656,707,1363,Osmaniye,Bahçe
50-54,691,670,1361,Osmaniye,Bahçe
55-59,587,589,1176,Osmaniye,Bahçe
60-64,548,488,1036,Osmaniye,Bahçe
65-69,327,360,687,Osmaniye,Bahçe
70-74,230,296,526,Osmaniye,Bahçe
75+,324,376,700,Osmaniye,Bahçe
18-24,11724,13391,25115,Şanlıurfa,Viranşehir
25-29,8083,8344,16427,Şanlıurfa,Viranşehir
30-34,6369,6621,12990,Şanlıurfa,Viranşehir
35-39,5618,5814,11432,Şanlıurfa,Viranşehir
40-44,3969,4191,8160,Şanlıurfa,Viranşehir
45-49,2830,2897,5727,Şanlıurfa,Viranşehir
50-54,2799,2900,5699,Şanlıurfa,Viranşehir
55-59,1957,2326,4283,Şanlıurfa,Viranşehir
60-64,1394,1461,2855,Şanlıurfa,Viranşehir
65-69,1016,1218,2234,Şanlıurfa,Viranşehir
70-74,712,883,1595,Şanlıurfa,Viranşehir
75+,787,1578,2365,Şanlıurfa,Viranşehir
18-24,331,317,648,Çorum,Uğurludağ
25-29,169,154,323,Çorum,Uğurludağ
30-34,150,139,289,Çorum,Uğurludağ
35-39,180,157,337,Çorum,Uğurludağ
40-44,171,150,321,Çorum,Uğurludağ
45-49,211,193,404,Çorum,Uğurludağ
50-54,216,175,391,Çorum,Uğurludağ
55-59,199,228,427,Çorum,Uğurludağ
60-64,201,242,443,Çorum,Uğurludağ
65-69,196,256,452,Çorum,Uğurludağ
70-74,138,165,303,Çorum,Uğurludağ
75+,271,325,596,Çorum,Uğurludağ
18-24,2913,2926,5839,Konya,Cihanbeyli
25-29,1909,1840,3749,Konya,Cihanbeyli
30-34,1990,1840,3830,Konya,Cihanbeyli
35-39,1853,1841,3694,Konya,Cihanbeyli
40-44,1599,1586,3185,Konya,Cihanbeyli
45-49,1421,1578,2999,Konya,Cihanbeyli
50-54,1438,1593,3031,Konya,Cihanbeyli
55-59,1354,1445,2799,Konya,Cihanbeyli
60-64,1166,1283,2449,Konya,Cihanbeyli
65-69,874,1095,1969,Konya,Cihanbeyli
70-74,582,798,1380,Konya,Cihanbeyli
75+,704,1077,1781,Konya,Cihanbeyli
18-24,3899,3941,7840,Zonguldak,Çaycuma
25-29,2557,2497,5054,Zonguldak,Çaycuma
30-34,2987,2987,5974,Zonguldak,Çaycuma
35-39,3566,3497,7063,Zonguldak,Çaycuma
40-44,3296,3358,6654,Zonguldak,Çaycuma
45-49,3091,3433,6524,Zonguldak,Çaycuma
50-54,3001,3318,6319,Zonguldak,Çaycuma
55-59,3302,3606,6908,Zonguldak,Çaycuma
60-64,3075,3435,6510,Zonguldak,Çaycuma
65-69,2546,2686,5232,Zonguldak,Çaycuma
70-74,1560,1853,3413,Zonguldak,Çaycuma
75+,1852,2868,4720,Zonguldak,Çaycuma
18-24,7399,7675,15074,Kocaeli,Gölcük
25-29,6281,5974,12255,Kocaeli,Gölcük
30-34,6326,6738,13064,Kocaeli,Gölcük
35-39,7653,7432,15085,Kocaeli,Gölcük
40-44,6496,5975,12471,Kocaeli,Gölcük
45-49,5189,5134,10323,Kocaeli,Gölcük
50-54,4524,4636,9160,Kocaeli,Gölcük
55-59,4038,4445,8483,Kocaeli,Gölcük
60-64,3762,3780,7542,Kocaeli,Gölcük
65-69,2614,2628,5242,Kocaeli,Gölcük
70-74,1549,1815,3364,Kocaeli,Gölcük
75+,1892,2645,4537,Kocaeli,Gölcük
18-24,22213,22311,44524,İstanbul,Maltepe
25-29,18597,19493,38090,İstanbul,Maltepe
30-34,21144,21362,42506,İstanbul,Maltepe
35-39,22398,22757,45155,İstanbul,Maltepe
40-44,19517,20495,40012,İstanbul,Maltepe
45-49,17434,18369,35803,İstanbul,Maltepe
50-54,14926,15775,30701,İstanbul,Maltepe
55-59,12840,13714,26554,İstanbul,Maltepe
60-64,9988,11417,21405,İstanbul,Maltepe
65-69,7217,8606,15823,İstanbul,Maltepe
70-74,4789,6158,10947,İstanbul,Maltepe
75+,6000,9996,15996,İstanbul,Maltepe
18-24,5773,5747,11520,Muş,Bulanık
25-29,3267,3126,6393,Muş,Bulanık
30-34,2373,2418,4791,Muş,Bulanık
35-39,2256,2236,4492,Muş,Bulanık
40-44,1825,1748,3573,Muş,Bulanık
45-49,1740,1478,3218,Muş,Bulanık
50-54,1377,1075,2452,Muş,Bulanık
55-59,1087,998,2085,Muş,Bulanık
60-64,972,1012,1984,Muş,Bulanık
65-69,611,799,1410,Muş,Bulanık
70-74,442,521,963,Muş,Bulanık
75+,509,852,1361,Muş,Bulanık
18-24,509,565,1074,Konya,Emirgazi
25-29,290,209,499,Konya,Emirgazi
30-34,280,238,518,Konya,Emirgazi
35-39,312,284,596,Konya,Emirgazi
40-44,293,268,561,Konya,Emirgazi
45-49,251,267,518,Konya,Emirgazi
50-54,234,239,473,Konya,Emirgazi
55-59,170,162,332,Konya,Emirgazi
60-64,116,156,272,Konya,Emirgazi
65-69,148,185,333,Konya,Emirgazi
70-74,103,158,261,Konya,Emirgazi
75+,137,207,344,Konya,Emirgazi
18-24,3574,3499,7073,Balıkesir,Gönen
25-29,2275,2247,4522,Balıkesir,Gönen
30-34,2368,2293,4661,Balıkesir,Gönen
35-39,2666,2665,5331,Balıkesir,Gönen
40-44,2652,2758,5410,Balıkesir,Gönen
45-49,2803,2793,5596,Balıkesir,Gönen
50-54,2745,2692,5437,Balıkesir,Gönen
55-59,2663,2901,5564,Balıkesir,Gönen
60-64,2429,2420,4849,Balıkesir,Gönen
65-69,1880,1943,3823,Balıkesir,Gönen
70-74,1327,1514,2841,Balıkesir,Gönen
75+,1725,2539,4264,Balıkesir,Gönen
18-24,1653,1681,3334,İzmir,Dikili
25-29,1226,1173,2399,İzmir,Dikili
30-34,1243,1221,2464,İzmir,Dikili
35-39,1442,1391,2833,İzmir,Dikili
40-44,1362,1365,2727,İzmir,Dikili
45-49,1312,1466,2778,İzmir,Dikili
50-54,1596,1751,3347,İzmir,Dikili
55-59,1788,2075,3863,İzmir,Dikili
60-64,2072,2173,4245,İzmir,Dikili
65-69,1900,1915,3815,İzmir,Dikili
70-74,1525,1373,2898,İzmir,Dikili
75+,1606,1673,3279,İzmir,Dikili
18-24,2628,2943,5571,Tokat,Niksar
25-29,1768,1681,3449,Tokat,Niksar
30-34,1650,1556,3206,Tokat,Niksar
35-39,1769,1725,3494,Tokat,Niksar
40-44,1734,1713,3447,Tokat,Niksar
45-49,1775,1875,3650,Tokat,Niksar
50-54,1948,2073,4021,Tokat,Niksar
55-59,2090,2183,4273,Tokat,Niksar
60-64,2044,2092,4136,Tokat,Niksar
65-69,1717,1981,3698,Tokat,Niksar
70-74,1339,1631,2970,Tokat,Niksar
75+,1773,2423,4196,Tokat,Niksar
18-24,337,351,688,Kastamonu,Bozkurt
25-29,228,210,438,Kastamonu,Bozkurt
30-34,276,270,546,Kastamonu,Bozkurt
35-39,304,254,558,Kastamonu,Bozkurt
40-44,246,257,503,Kastamonu,Bozkurt
45-49,222,262,484,Kastamonu,Bozkurt
50-54,316,307,623,Kastamonu,Bozkurt
55-59,426,448,874,Kastamonu,Bozkurt
60-64,450,441,891,Kastamonu,Bozkurt
65-69,390,426,816,Kastamonu,Bozkurt
70-74,254,268,522,Kastamonu,Bozkurt
75+,412,524,936,Kastamonu,Bozkurt
18-24,772,694,1466,Kırklareli,Pınarhisar
25-29,586,452,1038,Kırklareli,Pınarhisar
30-34,509,449,958,Kırklareli,Pınarhisar
35-39,632,548,1180,Kırklareli,Pınarhisar
40-44,562,538,1100,Kırklareli,Pınarhisar
45-49,634,565,1199,Kırklareli,Pınarhisar
50-54,679,673,1352,Kırklareli,Pınarhisar
55-59,710,709,1419,Kırklareli,Pınarhisar
60-64,685,681,1366,Kırklareli,Pınarhisar
65-69,485,566,1051,Kırklareli,Pınarhisar
70-74,399,443,842,Kırklareli,Pınarhisar
75+,670,1048,1718,Kırklareli,Pınarhisar
18-24,1256,1268,2524,Balıkesir,Erdek
25-29,969,876,1845,Balıkesir,Erdek
30-34,974,947,1921,Balıkesir,Erdek
35-39,1053,952,2005,Balıkesir,Erdek
40-44,1061,1001,2062,Balıkesir,Erdek
45-49,1070,1178,2248,Balıkesir,Erdek
50-54,1185,1225,2410,Balıkesir,Erdek
55-59,1336,1465,2801,Balıkesir,Erdek
60-64,1268,1359,2627,Balıkesir,Erdek
65-69,1105,1231,2336,Balıkesir,Erdek
70-74,866,878,1744,Balıkesir,Erdek
75+,1152,1396,2548,Balıkesir,Erdek
18-24,1714,1754,3468,İzmir,Selçuk
25-29,1260,1164,2424,İzmir,Selçuk
30-34,1241,1209,2450,İzmir,Selçuk
35-39,1406,1404,2810,İzmir,Selçuk
40-44,1333,1349,2682,İzmir,Selçuk
45-49,1248,1333,2581,İzmir,Selçuk
50-54,1298,1285,2583,İzmir,Selçuk
55-59,1258,1219,2477,İzmir,Selçuk
60-64,1039,1078,2117,İzmir,Selçuk
65-69,786,806,1592,İzmir,Selçuk
70-74,541,563,1104,İzmir,Selçuk
75+,694,1061,1755,İzmir,Selçuk
18-24,1285,1281,2566,Tekirdağ,Şarköy
25-29,966,891,1857,Tekirdağ,Şarköy
30-34,991,918,1909,Tekirdağ,Şarköy
35-39,1052,1040,2092,Tekirdağ,Şarköy
40-44,987,938,1925,Tekirdağ,Şarköy
45-49,1126,1155,2281,Tekirdağ,Şarköy
50-54,1212,1285,2497,Tekirdağ,Şarköy
55-59,1314,1410,2724,Tekirdağ,Şarköy
60-64,1298,1350,2648,Tekirdağ,Şarköy
65-69,1160,1133,2293,Tekirdağ,Şarköy
70-74,829,829,1658,Tekirdağ,Şarköy
75+,1071,1221,2292,Tekirdağ,Şarköy
18-24,27107,27615,54722,İstanbul,Gaziosmanpaşa
25-29,19849,19607,39456,İstanbul,Gaziosmanpaşa
30-34,21022,20657,41679,İstanbul,Gaziosmanpaşa
35-39,22891,21901,44792,İstanbul,Gaziosmanpaşa
40-44,19726,18879,38605,İstanbul,Gaziosmanpaşa
45-49,17040,16432,33472,İstanbul,Gaziosmanpaşa
50-54,14396,13801,28197,İstanbul,Gaziosmanpaşa
55-59,11586,11367,22953,İstanbul,Gaziosmanpaşa
60-64,8641,8898,17539,İstanbul,Gaziosmanpaşa
65-69,5460,6150,11610,İstanbul,Gaziosmanpaşa
70-74,3051,3922,6973,İstanbul,Gaziosmanpaşa
75+,3401,5861,9262,İstanbul,Gaziosmanpaşa
18-24,2286,2344,4630,Tekirdağ,Saray
25-29,1857,1701,3558,Tekirdağ,Saray
30-34,1942,1855,3797,Tekirdağ,Saray
35-39,2163,1946,4109,Tekirdağ,Saray
40-44,1824,1672,3496,Tekirdağ,Saray
45-49,1743,1796,3539,Tekirdağ,Saray
50-54,1747,1617,3364,Tekirdağ,Saray
55-59,1707,1643,3350,Tekirdağ,Saray
60-64,1365,1327,2692,Tekirdağ,Saray
65-69,990,1053,2043,Tekirdağ,Saray
70-74,608,653,1261,Tekirdağ,Saray
75+,821,1183,2004,Tekirdağ,Saray
18-24,2305,2670,4975,Bursa,Yenişehir
25-29,1665,1690,3355,Bursa,Yenişehir
30-34,1828,1762,3590,Bursa,Yenişehir
35-39,1994,1912,3906,Bursa,Yenişehir
40-44,1753,1713,3466,Bursa,Yenişehir
45-49,1774,1741,3515,Bursa,Yenişehir
50-54,1759,1828,3587,Bursa,Yenişehir
55-59,1723,1782,3505,Bursa,Yenişehir
60-64,1541,1529,3070,Bursa,Yenişehir
65-69,1124,1340,2464,Bursa,Yenişehir
70-74,896,1084,1980,Bursa,Yenişehir
75+,1264,1775,3039,Bursa,Yenişehir
18-24,469,402,871,Burdur,Ağlasun
25-29,194,168,362,Burdur,Ağlasun
30-34,205,170,375,Burdur,Ağlasun
35-39,235,243,478,Burdur,Ağlasun
40-44,281,284,565,Burdur,Ağlasun
45-49,288,292,580,Burdur,Ağlasun
50-54,279,262,541,Burdur,Ağlasun
55-59,287,276,563,Burdur,Ağlasun
60-64,232,311,543,Burdur,Ağlasun
65-69,226,308,534,Burdur,Ağlasun
70-74,192,229,421,Burdur,Ağlasun
75+,308,436,744,Burdur,Ağlasun
18-24,2259,2259,4518,Aydın,Çine
25-29,1428,1391,2819,Aydın,Çine
30-34,1500,1464,2964,Aydın,Çine
35-39,1668,1611,3279,Aydın,Çine
40-44,1688,1672,3360,Aydın,Çine
45-49,1824,1734,3558,Aydın,Çine
50-54,1916,1817,3733,Aydın,Çine
55-59,1850,1887,3737,Aydın,Çine
60-64,1749,1649,3398,Aydın,Çine
65-69,1203,1416,2619,Aydın,Çine
70-74,946,1239,2185,Aydın,Çine
75+,1580,2269,3849,Aydın,Çine
18-24,1252,1253,2505,Sakarya,Kaynarca
25-29,846,782,1628,Sakarya,Kaynarca
30-34,880,716,1596,Sakarya,Kaynarca
35-39,833,745,1578,Sakarya,Kaynarca
40-44,805,753,1558,Sakarya,Kaynarca
45-49,784,766,1550,Sakarya,Kaynarca
50-54,813,785,1598,Sakarya,Kaynarca
55-59,780,772,1552,Sakarya,Kaynarca
60-64,672,636,1308,Sakarya,Kaynarca
65-69,443,528,971,Sakarya,Kaynarca
70-74,309,381,690,Sakarya,Kaynarca
75+,510,612,1122,Sakarya,Kaynarca
18-24,246,255,501,Çorum,Dodurga
25-29,150,138,288,Çorum,Dodurga
30-34,179,145,324,Çorum,Dodurga
35-39,205,179,384,Çorum,Dodurga
40-44,183,183,366,Çorum,Dodurga
45-49,189,195,384,Çorum,Dodurga
50-54,244,229,473,Çorum,Dodurga
55-59,245,217,462,Çorum,Dodurga
60-64,225,275,500,Çorum,Dodurga
65-69,177,253,430,Çorum,Dodurga
70-74,155,197,352,Çorum,Dodurga
75+,267,377,644,Çorum,Dodurga
18-24,3630,3344,6974,İzmir,Balçova
25-29,2501,2509,5010,İzmir,Balçova
30-34,2517,2705,5222,İzmir,Balçova
35-39,2941,3104,6045,İzmir,Balçova
40-44,2663,3118,5781,İzmir,Balçova
45-49,2542,3034,5576,İzmir,Balçova
50-54,2544,2895,5439,İzmir,Balçova
55-59,2457,2690,5147,İzmir,Balçova
60-64,2092,2478,4570,İzmir,Balçova
65-69,1634,2058,3692,İzmir,Balçova
70-74,1338,1692,3030,İzmir,Balçova
75+,1815,2499,4314,İzmir,Balçova
18-24,10166,11339,21505,Bolu,Bolu Merkez
25-29,6798,6812,13610,Bolu,Bolu Merkez
30-34,7127,7110,14237,Bolu,Bolu Merkez
35-39,7818,8161,15979,Bolu,Bolu Merkez
40-44,7158,7396,14554,Bolu,Bolu Merkez
45-49,6386,6519,12905,Bolu,Bolu Merkez
50-54,5533,5730,11263,Bolu,Bolu Merkez
55-59,4886,5155,10041,Bolu,Bolu Merkez
60-64,4186,4424,8610,Bolu,Bolu Merkez
65-69,3125,3438,6563,Bolu,Bolu Merkez
70-74,1979,2326,4305,Bolu,Bolu Merkez
75+,2811,4036,6847,Bolu,Bolu Merkez
18-24,22427,23907,46334,İstanbul,Sancaktepe
25-29,18649,19180,37829,İstanbul,Sancaktepe
30-34,20435,19377,39812,İstanbul,Sancaktepe
35-39,20413,18861,39274,İstanbul,Sancaktepe
40-44,16327,14699,31026,İstanbul,Sancaktepe
45-49,12749,11321,24070,İstanbul,Sancaktepe
50-54,10056,8901,18957,İstanbul,Sancaktepe
55-59,6976,6317,13293,İstanbul,Sancaktepe
60-64,4548,4316,8864,İstanbul,Sancaktepe
65-69,2439,2921,5360,İstanbul,Sancaktepe
70-74,1402,1855,3257,İstanbul,Sancaktepe
75+,1550,2644,4194,İstanbul,Sancaktepe
18-24,333,342,675,Mersin,Çamlıyayla
25-29,219,210,429,Mersin,Çamlıyayla
30-34,253,174,427,Mersin,Çamlıyayla
35-39,265,193,458,Mersin,Çamlıyayla
40-44,243,202,445,Mersin,Çamlıyayla
45-49,281,277,558,Mersin,Çamlıyayla
50-54,335,319,654,Mersin,Çamlıyayla
55-59,335,333,668,Mersin,Çamlıyayla
60-64,321,324,645,Mersin,Çamlıyayla
65-69,279,272,551,Mersin,Çamlıyayla
70-74,223,227,450,Mersin,Çamlıyayla
75+,309,370,679,Mersin,Çamlıyayla
18-24,1177,1172,2349,Burdur,Gölhisar
25-29,659,645,1304,Burdur,Gölhisar
30-34,654,659,1313,Burdur,Gölhisar
35-39,727,712,1439,Burdur,Gölhisar
40-44,748,718,1466,Burdur,Gölhisar
45-49,760,689,1449,Burdur,Gölhisar
50-54,775,791,1566,Burdur,Gölhisar
55-59,762,736,1498,Burdur,Gölhisar
60-64,660,672,1332,Burdur,Gölhisar
65-69,436,493,929,Burdur,Gölhisar
70-74,281,390,671,Burdur,Gölhisar
75+,630,780,1410,Burdur,Gölhisar
18-24,841,777,1618,Kırıkkale,Keskin
25-29,482,336,818,Kırıkkale,Keskin
30-34,463,339,802,Kırıkkale,Keskin
35-39,514,391,905,Kırıkkale,Keskin
40-44,467,436,903,Kırıkkale,Keskin
45-49,531,546,1077,Kırıkkale,Keskin
50-54,640,528,1168,Kırıkkale,Keskin
55-59,548,542,1090,Kırıkkale,Keskin
60-64,512,519,1031,Kırıkkale,Keskin
65-69,406,531,937,Kırıkkale,Keskin
70-74,349,403,752,Kırıkkale,Keskin
75+,446,691,1137,Kırıkkale,Keskin
18-24,4909,5010,9919,Burdur,Burdur Merkez
25-29,3257,3167,6424,Burdur,Burdur Merkez
30-34,3515,3493,7008,Burdur,Burdur Merkez
35-39,3628,3740,7368,Burdur,Burdur Merkez
40-44,3640,3645,7285,Burdur,Burdur Merkez
45-49,3263,3428,6691,Burdur,Burdur Merkez
50-54,3229,3284,6513,Burdur,Burdur Merkez
55-59,3151,3397,6548,Burdur,Burdur Merkez
60-64,2682,3019,5701,Burdur,Burdur Merkez
65-69,2084,2141,4225,Burdur,Burdur Merkez
70-74,1347,1748,3095,Burdur,Burdur Merkez
75+,2111,3057,5168,Burdur,Burdur Merkez
18-24,571,588,1159,Kütahya,Domaniç
25-29,371,366,737,Kütahya,Domaniç
30-34,413,413,826,Kütahya,Domaniç
35-39,505,480,985,Kütahya,Domaniç
40-44,428,441,869,Kütahya,Domaniç
45-49,452,502,954,Kütahya,Domaniç
50-54,565,649,1214,Kütahya,Domaniç
55-59,661,700,1361,Kütahya,Domaniç
60-64,562,558,1120,Kütahya,Domaniç
65-69,448,512,960,Kütahya,Domaniç
70-74,312,352,664,Kütahya,Domaniç
75+,464,632,1096,Kütahya,Domaniç
18-24,1768,1718,3486,Muğla,Köyceğiz
25-29,1207,1136,2343,Muğla,Köyceğiz
30-34,1260,1203,2463,Muğla,Köyceğiz
35-39,1380,1319,2699,Muğla,Köyceğiz
40-44,1337,1342,2679,Muğla,Köyceğiz
45-49,1260,1346,2606,Muğla,Köyceğiz
50-54,1296,1210,2506,Muğla,Köyceğiz
55-59,1154,1131,2285,Muğla,Köyceğiz
60-64,1034,997,2031,Muğla,Köyceğiz
65-69,747,759,1506,Muğla,Köyceğiz
70-74,507,535,1042,Muğla,Köyceğiz
75+,771,983,1754,Muğla,Köyceğiz
18-24,562,532,1094,Kastamonu,Devrekani
25-29,356,313,669,Kastamonu,Devrekani
30-34,346,343,689,Kastamonu,Devrekani
35-39,424,374,798,Kastamonu,Devrekani
40-44,374,359,733,Kastamonu,Devrekani
45-49,381,356,737,Kastamonu,Devrekani
50-54,392,428,820,Kastamonu,Devrekani
55-59,449,444,893,Kastamonu,Devrekani
60-64,489,499,988,Kastamonu,Devrekani
65-69,345,422,767,Kastamonu,Devrekani
70-74,290,344,634,Kastamonu,Devrekani
75+,436,638,1074,Kastamonu,Devrekani
18-24,1282,1297,2579,Iğdır,Aralık
25-29,870,747,1617,Iğdır,Aralık
30-34,789,737,1526,Iğdır,Aralık
35-39,703,625,1328,Iğdır,Aralık
40-44,607,523,1130,Iğdır,Aralık
45-49,506,454,960,Iğdır,Aralık
50-54,466,415,881,Iğdır,Aralık
55-59,336,368,704,Iğdır,Aralık
60-64,297,335,632,Iğdır,Aralık
65-69,233,264,497,Iğdır,Aralık
70-74,154,198,352,Iğdır,Aralık
75+,190,301,491,Iğdır,Aralık
18-24,4148,4345,8493,Sakarya,Hendek
25-29,2864,2970,5834,Sakarya,Hendek
30-34,3019,2745,5764,Sakarya,Hendek
35-39,3203,3139,6342,Sakarya,Hendek
40-44,2965,2804,5769,Sakarya,Hendek
45-49,2600,2554,5154,Sakarya,Hendek
50-54,2403,2359,4762,Sakarya,Hendek
55-59,2228,2209,4437,Sakarya,Hendek
60-64,1929,1882,3811,Sakarya,Hendek
65-69,1317,1441,2758,Sakarya,Hendek
70-74,904,1008,1912,Sakarya,Hendek
75+,1182,1867,3049,Sakarya,Hendek
18-24,583,629,1212,Giresun,Eynesil
25-29,294,285,579,Giresun,Eynesil
30-34,265,267,532,Giresun,Eynesil
35-39,321,337,658,Giresun,Eynesil
40-44,365,348,713,Giresun,Eynesil
45-49,416,421,837,Giresun,Eynesil
50-54,464,456,920,Giresun,Eynesil
55-59,493,554,1047,Giresun,Eynesil
60-64,553,566,1119,Giresun,Eynesil
65-69,416,422,838,Giresun,Eynesil
70-74,217,328,545,Giresun,Eynesil
75+,508,831,1339,Giresun,Eynesil
18-24,1562,1637,3199,Çorum,Alaca
25-29,937,934,1871,Çorum,Alaca
30-34,951,850,1801,Çorum,Alaca
35-39,998,930,1928,Çorum,Alaca
40-44,921,933,1854,Çorum,Alaca
45-49,929,978,1907,Çorum,Alaca
50-54,1061,1014,2075,Çorum,Alaca
55-59,1015,1029,2044,Çorum,Alaca
60-64,930,951,1881,Çorum,Alaca
65-69,830,941,1771,Çorum,Alaca
70-74,656,770,1426,Çorum,Alaca
75+,1011,1504,2515,Çorum,Alaca
18-24,12073,12837,24910,Muş,Muş Merkez
25-29,8854,8632,17486,Muş,Muş Merkez
30-34,7270,6483,13753,Muş,Muş Merkez
35-39,6857,6089,12946,Muş,Muş Merkez
40-44,4764,4513,9277,Muş,Muş Merkez
45-49,3863,3295,7158,Muş,Muş Merkez
50-54,3513,2862,6375,Muş,Muş Merkez
55-59,2582,2446,5028,Muş,Muş Merkez
60-64,1987,2002,3989,Muş,Muş Merkez
65-69,1336,1604,2940,Muş,Muş Merkez
70-74,891,965,1856,Muş,Muş Merkez
75+,981,1462,2443,Muş,Muş Merkez
18-24,12550,12756,25306,Isparta,Isparta Merkez
25-29,8388,8286,16674,Isparta,Isparta Merkez
30-34,8642,8806,17448,Isparta,Isparta Merkez
35-39,9281,9870,19151,Isparta,Isparta Merkez
40-44,8945,9185,18130,Isparta,Isparta Merkez
45-49,7981,8233,16214,Isparta,Isparta Merkez
50-54,7056,7219,14275,Isparta,Isparta Merkez
55-59,6576,6822,13398,Isparta,Isparta Merkez
60-64,5377,5682,11059,Isparta,Isparta Merkez
65-69,3963,4112,8075,Isparta,Isparta Merkez
70-74,2255,2700,4955,Isparta,Isparta Merkez
75+,3215,4236,7451,Isparta,Isparta Merkez
18-24,1730,1816,3546,Muğla,Dalaman
25-29,1238,1302,2540,Muğla,Dalaman
30-34,1325,1388,2713,Muğla,Dalaman
35-39,1533,1614,3147,Muğla,Dalaman
40-44,1682,1540,3222,Muğla,Dalaman
45-49,1481,1411,2892,Muğla,Dalaman
50-54,1378,1255,2633,Muğla,Dalaman
55-59,1226,1091,2317,Muğla,Dalaman
60-64,931,930,1861,Muğla,Dalaman
65-69,727,681,1408,Muğla,Dalaman
70-74,427,491,918,Muğla,Dalaman
75+,589,757,1346,Muğla,Dalaman
18-24,193,192,385,Kastamonu,Şenpazar
25-29,152,119,271,Kastamonu,Şenpazar
30-34,135,108,243,Kastamonu,Şenpazar
35-39,107,97,204,Kastamonu,Şenpazar
40-44,118,98,216,Kastamonu,Şenpazar
45-49,115,118,233,Kastamonu,Şenpazar
50-54,125,131,256,Kastamonu,Şenpazar
55-59,213,192,405,Kastamonu,Şenpazar
60-64,224,228,452,Kastamonu,Şenpazar
65-69,203,191,394,Kastamonu,Şenpazar
70-74,134,160,294,Kastamonu,Şenpazar
75+,255,251,506,Kastamonu,Şenpazar
18-24,545,553,1098,Afyonkarahisar,Dazkırı
25-29,378,374,752,Afyonkarahisar,Dazkırı
30-34,403,342,745,Afyonkarahisar,Dazkırı
35-39,412,345,757,Afyonkarahisar,Dazkırı
40-44,346,337,683,Afyonkarahisar,Dazkırı
45-49,378,320,698,Afyonkarahisar,Dazkırı
50-54,379,402,781,Afyonkarahisar,Dazkırı
55-59,339,365,704,Afyonkarahisar,Dazkırı
60-64,291,320,611,Afyonkarahisar,Dazkırı
65-69,241,279,520,Afyonkarahisar,Dazkırı
70-74,148,232,380,Afyonkarahisar,Dazkırı
75+,283,469,752,Afyonkarahisar,Dazkırı
18-24,7245,7538,14783,Kırşehir,Kırşehir Merkez
25-29,4515,4966,9481,Kırşehir,Kırşehir Merkez
30-34,5067,5074,10141,Kırşehir,Kırşehir Merkez
35-39,5340,5258,10598,Kırşehir,Kırşehir Merkez
40-44,4712,4841,9553,Kırşehir,Kırşehir Merkez
45-49,4553,4581,9134,Kırşehir,Kırşehir Merkez
50-54,4419,4515,8934,Kırşehir,Kırşehir Merkez
55-59,3878,3945,7823,Kırşehir,Kırşehir Merkez
60-64,3168,3357,6525,Kırşehir,Kırşehir Merkez
65-69,2178,2408,4586,Kırşehir,Kırşehir Merkez
70-74,1373,1782,3155,Kırşehir,Kırşehir Merkez
75+,1780,2725,4505,Kırşehir,Kırşehir Merkez
18-24,837,930,1767,Aydın,Sultanhisar
25-29,599,620,1219,Aydın,Sultanhisar
30-34,616,569,1185,Aydın,Sultanhisar
35-39,693,692,1385,Aydın,Sultanhisar
40-44,643,614,1257,Aydın,Sultanhisar
45-49,657,657,1314,Aydın,Sultanhisar
50-54,656,630,1286,Aydın,Sultanhisar
55-59,720,689,1409,Aydın,Sultanhisar
60-64,618,696,1314,Aydın,Sultanhisar
65-69,457,525,982,Aydın,Sultanhisar
70-74,369,482,851,Aydın,Sultanhisar
75+,592,925,1517,Aydın,Sultanhisar
18-24,204,195,399,Konya,Derbent
25-29,107,80,187,Konya,Derbent
30-34,96,92,188,Konya,Derbent
35-39,129,127,256,Konya,Derbent
40-44,135,133,268,Konya,Derbent
45-49,141,155,296,Konya,Derbent
50-54,135,130,265,Konya,Derbent
55-59,149,139,288,Konya,Derbent
60-64,133,180,313,Konya,Derbent
65-69,126,163,289,Konya,Derbent
70-74,73,129,202,Konya,Derbent
75+,149,203,352,Konya,Derbent
18-24,1383,1316,2699,Çanakkale,Ayvacık
25-29,943,855,1798,Çanakkale,Ayvacık
30-34,977,958,1935,Çanakkale,Ayvacık
35-39,1137,1082,2219,Çanakkale,Ayvacık
40-44,1121,1070,2191,Çanakkale,Ayvacık
45-49,1217,1134,2351,Çanakkale,Ayvacık
50-54,1206,1215,2421,Çanakkale,Ayvacık
55-59,1284,1335,2619,Çanakkale,Ayvacık
60-64,1330,1310,2640,Çanakkale,Ayvacık
65-69,1132,1142,2274,Çanakkale,Ayvacık
70-74,832,864,1696,Çanakkale,Ayvacık
75+,1075,1426,2501,Çanakkale,Ayvacık
18-24,294,312,606,Çankırı,Yapraklı
25-29,176,133,309,Çankırı,Yapraklı
30-34,136,114,250,Çankırı,Yapraklı
35-39,148,143,291,Çankırı,Yapraklı
40-44,131,155,286,Çankırı,Yapraklı
45-49,179,207,386,Çankırı,Yapraklı
50-54,245,242,487,Çankırı,Yapraklı
55-59,296,344,640,Çankırı,Yapraklı
60-64,378,445,823,Çankırı,Yapraklı
65-69,299,370,669,Çankırı,Yapraklı
70-74,281,318,599,Çankırı,Yapraklı
75+,466,579,1045,Çankırı,Yapraklı
18-24,8804,8894,17698,Diyarbakır,Ergani
25-29,5599,5583,11182,Diyarbakır,Ergani
30-34,4766,4476,9242,Diyarbakır,Ergani
35-39,4646,4537,9183,Diyarbakır,Ergani
40-44,3771,3657,7428,Diyarbakır,Ergani
45-49,3070,2778,5848,Diyarbakır,Ergani
50-54,2648,2458,5106,Diyarbakır,Ergani
55-59,2012,1889,3901,Diyarbakır,Ergani
60-64,1554,1528,3082,Diyarbakır,Ergani
65-69,997,1294,2291,Diyarbakır,Ergani
70-74,728,1043,1771,Diyarbakır,Ergani
75+,1229,1663,2892,Diyarbakır,Ergani
18-24,1796,1791,3587,Artvin,Artvin Merkez
25-29,1265,1315,2580,Artvin,Artvin Merkez
30-34,1514,1282,2796,Artvin,Artvin Merkez
35-39,1354,1247,2601,Artvin,Artvin Merkez
40-44,1225,1147,2372,Artvin,Artvin Merkez
45-49,1150,1103,2253,Artvin,Artvin Merkez
50-54,1084,1039,2123,Artvin,Artvin Merkez
55-59,967,907,1874,Artvin,Artvin Merkez
60-64,765,793,1558,Artvin,Artvin Merkez
65-69,523,576,1099,Artvin,Artvin Merkez
70-74,349,456,805,Artvin,Artvin Merkez
75+,572,865,1437,Artvin,Artvin Merkez
18-24,8484,8860,17344,Kocaeli,Körfez
25-29,6558,6752,13310,Kocaeli,Körfez
30-34,7050,6865,13915,Kocaeli,Körfez
35-39,7282,6898,14180,Kocaeli,Körfez
40-44,6174,5748,11922,Kocaeli,Körfez
45-49,5116,4968,10084,Kocaeli,Körfez
50-54,4489,4319,8808,Kocaeli,Körfez
55-59,3807,3678,7485,Kocaeli,Körfez
60-64,2959,3252,6211,Kocaeli,Körfez
65-69,2174,2372,4546,Kocaeli,Körfez
70-74,1380,1579,2959,Kocaeli,Körfez
75+,1610,2284,3894,Kocaeli,Körfez
18-24,16685,17416,34101,Mersin,Toroslar
25-29,11149,11423,22572,Mersin,Toroslar
30-34,11124,11372,22496,Mersin,Toroslar
35-39,11889,11921,23810,Mersin,Toroslar
40-44,10444,10353,20797,Mersin,Toroslar
45-49,9387,9309,18696,Mersin,Toroslar
50-54,8629,8077,16706,Mersin,Toroslar
55-59,6969,6639,13608,Mersin,Toroslar
60-64,5216,5513,10729,Mersin,Toroslar
65-69,3770,3965,7735,Mersin,Toroslar
70-74,2427,2826,5253,Mersin,Toroslar
75+,2753,3982,6735,Mersin,Toroslar
18-24,21415,21909,43324,İstanbul,Avcılar
25-29,17494,17637,35131,İstanbul,Avcılar
30-34,19074,18936,38010,İstanbul,Avcılar
35-39,20166,19355,39521,İstanbul,Avcılar
40-44,17027,16382,33409,İstanbul,Avcılar
45-49,14293,13960,28253,İstanbul,Avcılar
50-54,11848,12031,23879,İstanbul,Avcılar
55-59,9897,10186,20083,İstanbul,Avcılar
60-64,7533,7977,15510,İstanbul,Avcılar
65-69,4943,5665,10608,İstanbul,Avcılar
70-74,2984,3645,6629,İstanbul,Avcılar
75+,3059,4870,7929,İstanbul,Avcılar
18-24,2809,2746,5555,Van,Gürpınar
25-29,1675,1425,3100,Van,Gürpınar
30-34,1209,964,2173,Van,Gürpınar
35-39,1079,1055,2134,Van,Gürpınar
40-44,815,666,1481,Van,Gürpınar
45-49,702,573,1275,Van,Gürpınar
50-54,723,682,1405,Van,Gürpınar
55-59,533,503,1036,Van,Gürpınar
60-64,407,513,920,Van,Gürpınar
65-69,279,321,600,Van,Gürpınar
70-74,205,258,463,Van,Gürpınar
75+,238,298,536,Van,Gürpınar
18-24,465,451,916,Afyonkarahisar,Bayat
25-29,236,218,454,Afyonkarahisar,Bayat
30-34,253,243,496,Afyonkarahisar,Bayat
35-39,275,239,514,Afyonkarahisar,Bayat
40-44,233,251,484,Afyonkarahisar,Bayat
45-49,214,235,449,Afyonkarahisar,Bayat
50-54,227,199,426,Afyonkarahisar,Bayat
55-59,213,201,414,Afyonkarahisar,Bayat
60-64,165,186,351,Afyonkarahisar,Bayat
65-69,142,193,335,Afyonkarahisar,Bayat
70-74,115,163,278,Afyonkarahisar,Bayat
75+,248,330,578,Afyonkarahisar,Bayat
18-24,721,855,1576,Yozgat,Saraykent
25-29,469,370,839,Yozgat,Saraykent
30-34,396,333,729,Yozgat,Saraykent
35-39,361,339,700,Yozgat,Saraykent
40-44,341,356,697,Yozgat,Saraykent
45-49,303,299,602,Yozgat,Saraykent
50-54,291,348,639,Yozgat,Saraykent
55-59,289,307,596,Yozgat,Saraykent
60-64,278,293,571,Yozgat,Saraykent
65-69,236,273,509,Yozgat,Saraykent
70-74,181,209,390,Yozgat,Saraykent
75+,211,302,513,Yozgat,Saraykent
18-24,1595,1607,3202,Erzurum,Hınıs
25-29,1027,972,1999,Erzurum,Hınıs
30-34,899,719,1618,Erzurum,Hınıs
35-39,819,822,1641,Erzurum,Hınıs
40-44,646,632,1278,Erzurum,Hınıs
45-49,590,543,1133,Erzurum,Hınıs
50-54,581,561,1142,Erzurum,Hınıs
55-59,563,569,1132,Erzurum,Hınıs
60-64,528,544,1072,Erzurum,Hınıs
65-69,407,487,894,Erzurum,Hınıs
70-74,272,307,579,Erzurum,Hınıs
75+,358,465,823,Erzurum,Hınıs
18-24,2619,2821,5440,Tokat,Zile
25-29,1331,1394,2725,Tokat,Zile
30-34,1390,1500,2890,Tokat,Zile
35-39,1609,1758,3367,Tokat,Zile
40-44,1706,1824,3530,Tokat,Zile
45-49,1763,1772,3535,Tokat,Zile
50-54,1714,1911,3625,Tokat,Zile
55-59,1912,1926,3838,Tokat,Zile
60-64,1796,1997,3793,Tokat,Zile
65-69,1784,1960,3744,Tokat,Zile
70-74,1223,1517,2740,Tokat,Zile
75+,1675,1955,3630,Tokat,Zile
18-24,958,844,1802,Ankara,Bala
25-29,658,429,1087,Ankara,Bala
30-34,622,445,1067,Ankara,Bala
35-39,668,466,1134,Ankara,Bala
40-44,658,486,1144,Ankara,Bala
45-49,740,649,1389,Ankara,Bala
50-54,808,677,1485,Ankara,Bala
55-59,828,788,1616,Ankara,Bala
60-64,762,737,1499,Ankara,Bala
65-69,606,668,1274,Ankara,Bala
70-74,367,447,814,Ankara,Bala
75+,477,724,1201,Ankara,Bala
18-24,20801,21755,42556,Kayseri,Kocasinan
25-29,13211,13911,27122,Kayseri,Kocasinan
30-34,15046,15129,30175,Kayseri,Kocasinan
35-39,15800,16025,31825,Kayseri,Kocasinan
40-44,14221,14237,28458,Kayseri,Kocasinan
45-49,12383,12061,24444,Kayseri,Kocasinan
50-54,10648,10824,21472,Kayseri,Kocasinan
55-59,9030,9474,18504,Kayseri,Kocasinan
60-64,7609,7746,15355,Kayseri,Kocasinan
65-69,5621,6197,11818,Kayseri,Kocasinan
70-74,3746,4599,8345,Kayseri,Kocasinan
75+,4603,6900,11503,Kayseri,Kocasinan
18-24,499,513,1012,Isparta,Senirkent
25-29,300,303,603,Isparta,Senirkent
30-34,305,266,571,Isparta,Senirkent
35-39,362,352,714,Isparta,Senirkent
40-44,367,336,703,Isparta,Senirkent
45-49,346,346,692,Isparta,Senirkent
50-54,347,345,692,Isparta,Senirkent
55-59,373,423,796,Isparta,Senirkent
60-64,376,431,807,Isparta,Senirkent
65-69,326,386,712,Isparta,Senirkent
70-74,266,339,605,Isparta,Senirkent
75+,406,654,1060,Isparta,Senirkent
18-24,768,783,1551,Malatya,Yazıhan
25-29,496,407,903,Malatya,Yazıhan
30-34,472,351,823,Malatya,Yazıhan
35-39,421,419,840,Malatya,Yazıhan
40-44,449,419,868,Malatya,Yazıhan
45-49,384,386,770,Malatya,Yazıhan
50-54,424,362,786,Malatya,Yazıhan
55-59,357,326,683,Malatya,Yazıhan
60-64,344,321,665,Malatya,Yazıhan
65-69,233,267,500,Malatya,Yazıhan
70-74,203,243,446,Malatya,Yazıhan
75+,257,414,671,Malatya,Yazıhan
18-24,4170,4097,8267,Bursa,Karacabey
25-29,2869,2621,5490,Bursa,Karacabey
30-34,2877,2750,5627,Bursa,Karacabey
35-39,3053,3079,6132,Bursa,Karacabey
40-44,2844,2887,5731,Bursa,Karacabey
45-49,2796,2728,5524,Bursa,Karacabey
50-54,2636,2689,5325,Bursa,Karacabey
55-59,2791,2705,5496,Bursa,Karacabey
60-64,2258,2347,4605,Bursa,Karacabey
65-69,1789,1891,3680,Bursa,Karacabey
70-74,1215,1480,2695,Bursa,Karacabey
75+,1543,2338,3881,Bursa,Karacabey
18-24,496,488,984,Aydın,Karpuzlu
25-29,321,239,560,Aydın,Karpuzlu
30-34,312,260,572,Aydın,Karpuzlu
35-39,318,310,628,Aydın,Karpuzlu
40-44,324,291,615,Aydın,Karpuzlu
45-49,352,362,714,Aydın,Karpuzlu
50-54,430,412,842,Aydın,Karpuzlu
55-59,473,485,958,Aydın,Karpuzlu
60-64,442,456,898,Aydın,Karpuzlu
65-69,324,369,693,Aydın,Karpuzlu
70-74,246,297,543,Aydın,Karpuzlu
75+,447,657,1104,Aydın,Karpuzlu
18-24,1210,1182,2392,Kırklareli,Vize
25-29,849,733,1582,Kırklareli,Vize
30-34,914,753,1667,Kırklareli,Vize
35-39,950,828,1778,Kırklareli,Vize
40-44,943,867,1810,Kırklareli,Vize
45-49,922,903,1825,Kırklareli,Vize
50-54,1013,1041,2054,Kırklareli,Vize
55-59,1142,1059,2201,Kırklareli,Vize
60-64,1083,1132,2215,Kırklareli,Vize
65-69,826,800,1626,Kırklareli,Vize
70-74,545,657,1202,Kırklareli,Vize
75+,875,1198,2073,Kırklareli,Vize
18-24,4492,4595,9087,İzmir,Bergama
25-29,3225,3135,6360,İzmir,Bergama
30-34,3588,3466,7054,İzmir,Bergama
35-39,3883,3897,7780,İzmir,Bergama
40-44,3751,3715,7466,İzmir,Bergama
45-49,3598,3698,7296,İzmir,Bergama
50-54,3635,3636,7271,İzmir,Bergama
55-59,3580,3569,7149,İzmir,Bergama
60-64,3138,3150,6288,İzmir,Bergama
65-69,2339,2680,5019,İzmir,Bergama
70-74,1765,2088,3853,İzmir,Bergama
75+,2232,3558,5790,İzmir,Bergama
18-24,4895,4879,9774,Osmaniye,Düziçi
25-29,2340,2559,4899,Osmaniye,Düziçi
30-34,2668,2722,5390,Osmaniye,Düziçi
35-39,3103,3052,6155,Osmaniye,Düziçi
40-44,2723,2804,5527,Osmaniye,Düziçi
45-49,2779,2779,5558,Osmaniye,Düziçi
50-54,2475,2360,4835,Osmaniye,Düziçi
55-59,2027,1837,3864,Osmaniye,Düziçi
60-64,1652,1657,3309,Osmaniye,Düziçi
65-69,1151,1328,2479,Osmaniye,Düziçi
70-74,759,938,1697,Osmaniye,Düziçi
75+,788,1270,2058,Osmaniye,Düziçi
18-24,3704,3293,6997,Hatay,Altınözü
25-29,2043,1694,3737,Hatay,Altınözü
30-34,1821,1674,3495,Hatay,Altınözü
35-39,1663,1689,3352,Hatay,Altınözü
40-44,1593,1402,2995,Hatay,Altınözü
45-49,1546,1610,3156,Hatay,Altınözü
50-54,1472,1385,2857,Hatay,Altınözü
55-59,1159,1186,2345,Hatay,Altınözü
60-64,863,1079,1942,Hatay,Altınözü
65-69,597,886,1483,Hatay,Altınözü
70-74,562,703,1265,Hatay,Altınözü
75+,1014,1304,2318,Hatay,Altınözü
18-24,1424,1392,2816,Kayseri,Bünyan
25-29,907,741,1648,Kayseri,Bünyan
30-34,833,652,1485,Kayseri,Bünyan
35-39,847,716,1563,Kayseri,Bünyan
40-44,819,809,1628,Kayseri,Bünyan
45-49,802,819,1621,Kayseri,Bünyan
50-54,879,797,1676,Kayseri,Bünyan
55-59,788,795,1583,Kayseri,Bünyan
60-64,772,704,1476,Kayseri,Bünyan
65-69,576,650,1226,Kayseri,Bünyan
70-74,381,637,1018,Kayseri,Bünyan
75+,649,973,1622,Kayseri,Bünyan
18-24,764,717,1481,Düzce,Yığılca
25-29,414,364,778,Düzce,Yığılca
30-34,461,378,839,Düzce,Yığılca
35-39,463,431,894,Düzce,Yığılca
40-44,463,458,921,Düzce,Yığılca
45-49,525,458,983,Düzce,Yığılca
50-54,514,517,1031,Düzce,Yığılca
55-59,514,583,1097,Düzce,Yığılca
60-64,501,504,1005,Düzce,Yığılca
65-69,404,431,835,Düzce,Yığılca
70-74,277,297,574,Düzce,Yığılca
75+,378,453,831,Düzce,Yığılca
18-24,4539,2663,7202,Karabük,Safranbolu
25-29,2649,1834,4483,Karabük,Safranbolu
30-34,2057,2149,4206,Karabük,Safranbolu
35-39,2229,2227,4456,Karabük,Safranbolu
40-44,2162,2261,4423,Karabük,Safranbolu
45-49,2023,2145,4168,Karabük,Safranbolu
50-54,1858,1965,3823,Karabük,Safranbolu
55-59,1780,1930,3710,Karabük,Safranbolu
60-64,1733,1836,3569,Karabük,Safranbolu
65-69,1364,1428,2792,Karabük,Safranbolu
70-74,931,1067,1998,Karabük,Safranbolu
75+,1165,1758,2923,Karabük,Safranbolu
18-24,729,773,1502,Eskişehir,Çifteler
25-29,465,430,895,Eskişehir,Çifteler
30-34,487,419,906,Eskişehir,Çifteler
35-39,492,429,921,Eskişehir,Çifteler
40-44,488,445,933,Eskişehir,Çifteler
45-49,462,526,988,Eskişehir,Çifteler
50-54,554,562,1116,Eskişehir,Çifteler
55-59,575,519,1094,Eskişehir,Çifteler
60-64,417,433,850,Eskişehir,Çifteler
65-69,336,381,717,Eskişehir,Çifteler
70-74,266,335,601,Eskişehir,Çifteler
75+,409,552,961,Eskişehir,Çifteler
18-24,533,535,1068,Yozgat,Çayıralan
25-29,337,332,669,Yozgat,Çayıralan
30-34,360,314,674,Yozgat,Çayıralan
35-39,347,304,651,Yozgat,Çayıralan
40-44,330,290,620,Yozgat,Çayıralan
45-49,319,336,655,Yozgat,Çayıralan
50-54,385,399,784,Yozgat,Çayıralan
55-59,423,489,912,Yozgat,Çayıralan
60-64,463,466,929,Yozgat,Çayıralan
65-69,377,424,801,Yozgat,Çayıralan
70-74,319,415,734,Yozgat,Çayıralan
75+,418,631,1049,Yozgat,Çayıralan
18-24,1002,953,1955,Kırşehir,Mucur
25-29,532,581,1113,Kırşehir,Mucur
30-34,569,548,1117,Kırşehir,Mucur
35-39,603,582,1185,Kırşehir,Mucur
40-44,599,595,1194,Kırşehir,Mucur
45-49,613,620,1233,Kırşehir,Mucur
50-54,704,641,1345,Kırşehir,Mucur
55-59,632,645,1277,Kırşehir,Mucur
60-64,560,572,1132,Kırşehir,Mucur
65-69,445,487,932,Kırşehir,Mucur
70-74,261,361,622,Kırşehir,Mucur
75+,453,640,1093,Kırşehir,Mucur
18-24,153,131,284,Erzincan,Otlukbeli
25-29,86,77,163,Erzincan,Otlukbeli
30-34,73,64,137,Erzincan,Otlukbeli
35-39,72,82,154,Erzincan,Otlukbeli
40-44,99,72,171,Erzincan,Otlukbeli
45-49,95,80,175,Erzincan,Otlukbeli
50-54,82,87,169,Erzincan,Otlukbeli
55-59,69,72,141,Erzincan,Otlukbeli
60-64,74,71,145,Erzincan,Otlukbeli
65-69,74,63,137,Erzincan,Otlukbeli
70-74,35,46,81,Erzincan,Otlukbeli
75+,59,75,134,Erzincan,Otlukbeli
18-24,479,506,985,Afyonkarahisar,Başmakçı
25-29,321,273,594,Afyonkarahisar,Başmakçı
30-34,307,278,585,Afyonkarahisar,Başmakçı
35-39,379,305,684,Afyonkarahisar,Başmakçı
40-44,291,273,564,Afyonkarahisar,Başmakçı
45-49,343,355,698,Afyonkarahisar,Başmakçı
50-54,354,324,678,Afyonkarahisar,Başmakçı
55-59,347,387,734,Afyonkarahisar,Başmakçı
60-64,291,350,641,Afyonkarahisar,Başmakçı
65-69,221,258,479,Afyonkarahisar,Başmakçı
70-74,193,233,426,Afyonkarahisar,Başmakçı
75+,312,438,750,Afyonkarahisar,Başmakçı
18-24,253,219,472,Çorum,Oğuzlar
25-29,136,119,255,Çorum,Oğuzlar
30-34,147,115,262,Çorum,Oğuzlar
35-39,139,146,285,Çorum,Oğuzlar
40-44,140,128,268,Çorum,Oğuzlar
45-49,144,160,304,Çorum,Oğuzlar
50-54,187,221,408,Çorum,Oğuzlar
55-59,181,199,380,Çorum,Oğuzlar
60-64,207,241,448,Çorum,Oğuzlar
65-69,166,235,401,Çorum,Oğuzlar
70-74,161,178,339,Çorum,Oğuzlar
75+,267,295,562,Çorum,Oğuzlar
18-24,14516,15336,29852,Denizli,Merkezefendi
25-29,9737,10848,20585,Denizli,Merkezefendi
30-34,11570,12615,24185,Denizli,Merkezefendi
35-39,13384,14186,27570,Denizli,Merkezefendi
40-44,12047,12278,24325,Denizli,Merkezefendi
45-49,10613,10414,21027,Denizli,Merkezefendi
50-54,9340,9347,18687,Denizli,Merkezefendi
55-59,8037,8013,16050,Denizli,Merkezefendi
60-64,6376,6218,12594,Denizli,Merkezefendi
65-69,4409,4313,8722,Denizli,Merkezefendi
70-74,2501,2783,5284,Denizli,Merkezefendi
75+,2798,4081,6879,Denizli,Merkezefendi
18-24,2760,2675,5435,Antalya,Gazipaşa
25-29,1690,1511,3201,Antalya,Gazipaşa
30-34,1648,1582,3230,Antalya,Gazipaşa
35-39,1790,1837,3627,Antalya,Gazipaşa
40-44,1857,1869,3726,Antalya,Gazipaşa
45-49,1969,2033,4002,Antalya,Gazipaşa
50-54,1957,1867,3824,Antalya,Gazipaşa
55-59,1513,1414,2927,Antalya,Gazipaşa
60-64,1236,1192,2428,Antalya,Gazipaşa
65-69,853,925,1778,Antalya,Gazipaşa
70-74,573,661,1234,Antalya,Gazipaşa
75+,1091,1384,2475,Antalya,Gazipaşa
18-24,1779,2018,3797,Trabzon,Yomra
25-29,1293,1343,2636,Trabzon,Yomra
30-34,1517,1464,2981,Trabzon,Yomra
35-39,1452,1357,2809,Trabzon,Yomra
40-44,1253,1115,2368,Trabzon,Yomra
45-49,1134,1075,2209,Trabzon,Yomra
50-54,1094,1084,2178,Trabzon,Yomra
55-59,1026,954,1980,Trabzon,Yomra
60-64,831,903,1734,Trabzon,Yomra
65-69,632,651,1283,Trabzon,Yomra
70-74,423,588,1011,Trabzon,Yomra
75+,658,1087,1745,Trabzon,Yomra
18-24,379,389,768,Trabzon,Hayrat
25-29,157,176,333,Trabzon,Hayrat
30-34,174,170,344,Trabzon,Hayrat
35-39,217,202,419,Trabzon,Hayrat
40-44,214,226,440,Trabzon,Hayrat
45-49,275,259,534,Trabzon,Hayrat
50-54,312,282,594,Trabzon,Hayrat
55-59,337,320,657,Trabzon,Hayrat
60-64,342,348,690,Trabzon,Hayrat
65-69,300,320,620,Trabzon,Hayrat
70-74,180,240,420,Trabzon,Hayrat
75+,209,416,625,Trabzon,Hayrat
18-24,437,430,867,Edirne,Enez
25-29,310,277,587,Edirne,Enez
30-34,283,248,531,Edirne,Enez
35-39,293,287,580,Edirne,Enez
40-44,379,326,705,Edirne,Enez
45-49,397,325,722,Edirne,Enez
50-54,439,452,891,Edirne,Enez
55-59,504,506,1010,Edirne,Enez
60-64,533,526,1059,Edirne,Enez
65-69,405,414,819,Edirne,Enez
70-74,316,327,643,Edirne,Enez
75+,390,505,895,Edirne,Enez
18-24,2393,2239,4632,Afyonkarahisar,Bolvadin
25-29,1239,1404,2643,Afyonkarahisar,Bolvadin
30-34,1474,1391,2865,Afyonkarahisar,Bolvadin
35-39,1498,1555,3053,Afyonkarahisar,Bolvadin
40-44,1193,1285,2478,Afyonkarahisar,Bolvadin
45-49,1258,1376,2634,Afyonkarahisar,Bolvadin
50-54,1246,1394,2640,Afyonkarahisar,Bolvadin
55-59,1486,1455,2941,Afyonkarahisar,Bolvadin
60-64,1165,1122,2287,Afyonkarahisar,Bolvadin
65-69,885,967,1852,Afyonkarahisar,Bolvadin
70-74,536,688,1224,Afyonkarahisar,Bolvadin
75+,805,1083,1888,Afyonkarahisar,Bolvadin
18-24,8873,9324,18197,Adana,Ceyhan
25-29,5618,5860,11478,Adana,Ceyhan
30-34,5516,5582,11098,Adana,Ceyhan
35-39,5715,5572,11287,Adana,Ceyhan
40-44,4769,4946,9715,Adana,Ceyhan
45-49,4585,4609,9194,Adana,Ceyhan
50-54,4755,4710,9465,Adana,Ceyhan
55-59,4398,4398,8796,Adana,Ceyhan
60-64,3784,3718,7502,Adana,Ceyhan
65-69,2504,2808,5312,Adana,Ceyhan
70-74,1516,1930,3446,Adana,Ceyhan
75+,1962,3262,5224,Adana,Ceyhan
18-24,2149,2199,4348,Balıkesir,Bigadiç
25-29,1344,1244,2588,Balıkesir,Bigadiç
30-34,1519,1460,2979,Balıkesir,Bigadiç
35-39,1660,1629,3289,Balıkesir,Bigadiç
40-44,1638,1623,3261,Balıkesir,Bigadiç
45-49,1714,1732,3446,Balıkesir,Bigadiç
50-54,1736,1809,3545,Balıkesir,Bigadiç
55-59,1612,1777,3389,Balıkesir,Bigadiç
60-64,1445,1555,3000,Balıkesir,Bigadiç
65-69,1160,1330,2490,Balıkesir,Bigadiç
70-74,828,961,1789,Balıkesir,Bigadiç
75+,1344,1775,3119,Balıkesir,Bigadiç
18-24,2553,2510,5063,Mardin,Mazıdağı
25-29,1572,1422,2994,Mardin,Mazıdağı
30-34,1152,1076,2228,Mardin,Mazıdağı
35-39,1047,991,2038,Mardin,Mazıdağı
40-44,799,781,1580,Mardin,Mazıdağı
45-49,617,745,1362,Mardin,Mazıdağı
50-54,607,550,1157,Mardin,Mazıdağı
55-59,425,462,887,Mardin,Mazıdağı
60-64,315,334,649,Mardin,Mazıdağı
65-69,259,339,598,Mardin,Mazıdağı
70-74,191,270,461,Mardin,Mazıdağı
75+,358,479,837,Mardin,Mazıdağı
18-24,1092,1146,2238,Aydın,Kuyucak
25-29,771,771,1542,Aydın,Kuyucak
30-34,845,773,1618,Aydın,Kuyucak
35-39,992,928,1920,Aydın,Kuyucak
40-44,941,862,1803,Aydın,Kuyucak
45-49,937,963,1900,Aydın,Kuyucak
50-54,941,953,1894,Aydın,Kuyucak
55-59,1034,976,2010,Aydın,Kuyucak
60-64,919,1051,1970,Aydın,Kuyucak
65-69,721,778,1499,Aydın,Kuyucak
70-74,503,628,1131,Aydın,Kuyucak
75+,711,1231,1942,Aydın,Kuyucak
18-24,8626,8713,17339,Manisa,Turgutlu
25-29,6072,5959,12031,Manisa,Turgutlu
30-34,6323,6280,12603,Manisa,Turgutlu
35-39,6605,6450,13055,Manisa,Turgutlu
40-44,5771,5806,11577,Manisa,Turgutlu
45-49,5123,5083,10206,Manisa,Turgutlu
50-54,4905,4724,9629,Manisa,Turgutlu
55-59,4449,4450,8899,Manisa,Turgutlu
60-64,3652,3638,7290,Manisa,Turgutlu
65-69,2671,2843,5514,Manisa,Turgutlu
70-74,1713,1961,3674,Manisa,Turgutlu
75+,1943,3062,5005,Manisa,Turgutlu
18-24,2232,2277,4509,Zonguldak,Devrek
25-29,1428,1484,2912,Zonguldak,Devrek
30-34,1793,1612,3405,Zonguldak,Devrek
35-39,1862,1771,3633,Zonguldak,Devrek
40-44,1752,1696,3448,Zonguldak,Devrek
45-49,1657,1749,3406,Zonguldak,Devrek
50-54,1930,2227,4157,Zonguldak,Devrek
55-59,2350,2532,4882,Zonguldak,Devrek
60-64,2103,2347,4450,Zonguldak,Devrek
65-69,1858,2006,3864,Zonguldak,Devrek
70-74,1219,1388,2607,Zonguldak,Devrek
75+,1642,2264,3906,Zonguldak,Devrek
18-24,33269,34368,67637,Bursa,Yıldırım
25-29,24901,24492,49393,Bursa,Yıldırım
30-34,26349,25710,52059,Bursa,Yıldırım
35-39,28125,27726,55851,Bursa,Yıldırım
40-44,24356,23704,48060,Bursa,Yıldırım
45-49,21659,21207,42866,Bursa,Yıldırım
50-54,18742,18588,37330,Bursa,Yıldırım
55-59,16179,16275,32454,Bursa,Yıldırım
60-64,12658,13519,26177,Bursa,Yıldırım
65-69,9113,10080,19193,Bursa,Yıldırım
70-74,5411,6811,12222,Bursa,Yıldırım
75+,6673,10092,16765,Bursa,Yıldırım
18-24,1839,1690,3529,Diyarbakır,Lice
25-29,1364,1032,2396,Diyarbakır,Lice
30-34,812,735,1547,Diyarbakır,Lice
35-39,820,763,1583,Diyarbakır,Lice
40-44,583,640,1223,Diyarbakır,Lice
45-49,511,516,1027,Diyarbakır,Lice
50-54,493,467,960,Diyarbakır,Lice
55-59,384,430,814,Diyarbakır,Lice
60-64,348,320,668,Diyarbakır,Lice
65-69,334,329,663,Diyarbakır,Lice
70-74,214,298,512,Diyarbakır,Lice
75+,384,556,940,Diyarbakır,Lice
18-24,999,1158,2157,Van,Bahçesaray
25-29,535,576,1111,Van,Bahçesaray
30-34,347,354,701,Van,Bahçesaray
35-39,344,353,697,Van,Bahçesaray
40-44,313,354,667,Van,Bahçesaray
45-49,286,277,563,Van,Bahçesaray
50-54,240,198,438,Van,Bahçesaray
55-59,181,146,327,Van,Bahçesaray
60-64,176,187,363,Van,Bahçesaray
65-69,129,175,304,Van,Bahçesaray
70-74,92,85,177,Van,Bahçesaray
75+,107,134,241,Van,Bahçesaray
18-24,7975,8624,16599,Balıkesir,Karesi
25-29,5740,5911,11651,Balıkesir,Karesi
30-34,6321,6436,12757,Balıkesir,Karesi
35-39,6910,7206,14116,Balıkesir,Karesi
40-44,6874,7238,14112,Balıkesir,Karesi
45-49,6381,6538,12919,Balıkesir,Karesi
50-54,5889,6258,12147,Balıkesir,Karesi
55-59,5608,5946,11554,Balıkesir,Karesi
60-64,4751,4675,9426,Balıkesir,Karesi
65-69,3385,3596,6981,Balıkesir,Karesi
70-74,2246,2590,4836,Balıkesir,Karesi
75+,2986,4249,7235,Balıkesir,Karesi
18-24,6589,6605,13194,Ankara,Gölbaşı
25-29,4960,4776,9736,Ankara,Gölbaşı
30-34,4902,5111,10013,Ankara,Gölbaşı
35-39,5207,5424,10631,Ankara,Gölbaşı
40-44,4876,4735,9611,Ankara,Gölbaşı
45-49,4453,4255,8708,Ankara,Gölbaşı
50-54,3890,3618,7508,Ankara,Gölbaşı
55-59,3160,3028,6188,Ankara,Gölbaşı
60-64,2426,2272,4698,Ankara,Gölbaşı
65-69,1679,1662,3341,Ankara,Gölbaşı
70-74,945,1085,2030,Ankara,Gölbaşı
75+,1212,1726,2938,Ankara,Gölbaşı
18-24,310,341,651,Kastamonu,Doğanyurt
25-29,169,175,344,Kastamonu,Doğanyurt
30-34,145,130,275,Kastamonu,Doğanyurt
35-39,135,154,289,Kastamonu,Doğanyurt
40-44,155,147,302,Kastamonu,Doğanyurt
45-49,167,200,367,Kastamonu,Doğanyurt
50-54,207,191,398,Kastamonu,Doğanyurt
55-59,247,245,492,Kastamonu,Doğanyurt
60-64,212,229,441,Kastamonu,Doğanyurt
65-69,200,192,392,Kastamonu,Doğanyurt
70-74,132,130,262,Kastamonu,Doğanyurt
75+,208,214,422,Kastamonu,Doğanyurt
18-24,2377,2402,4779,Gaziantep,Nurdağı
25-29,1448,1481,2929,Gaziantep,Nurdağı
30-34,1443,1339,2782,Gaziantep,Nurdağı
35-39,1338,1239,2577,Gaziantep,Nurdağı
40-44,1120,1179,2299,Gaziantep,Nurdağı
45-49,1040,1003,2043,Gaziantep,Nurdağı
50-54,1048,1006,2054,Gaziantep,Nurdağı
55-59,850,838,1688,Gaziantep,Nurdağı
60-64,725,707,1432,Gaziantep,Nurdağı
65-69,538,590,1128,Gaziantep,Nurdağı
70-74,374,440,814,Gaziantep,Nurdağı
75+,449,661,1110,Gaziantep,Nurdağı
18-24,585,641,1226,Niğde,Çamardı
25-29,329,315,644,Niğde,Çamardı
30-34,345,299,644,Niğde,Çamardı
35-39,353,324,677,Niğde,Çamardı
40-44,356,357,713,Niğde,Çamardı
45-49,395,424,819,Niğde,Çamardı
50-54,359,401,760,Niğde,Çamardı
55-59,390,419,809,Niğde,Çamardı
60-64,322,395,717,Niğde,Çamardı
65-69,358,409,767,Niğde,Çamardı
70-74,276,363,639,Niğde,Çamardı
75+,427,566,993,Niğde,Çamardı
18-24,3468,3620,7088,Giresun,Bulancak
25-29,2304,2222,4526,Giresun,Bulancak
30-34,2254,2120,4374,Giresun,Bulancak
35-39,2179,2302,4481,Giresun,Bulancak
40-44,2160,2214,4374,Giresun,Bulancak
45-49,2122,2079,4201,Giresun,Bulancak
50-54,2344,2311,4655,Giresun,Bulancak
55-59,2220,1981,4201,Giresun,Bulancak
60-64,1922,1939,3861,Giresun,Bulancak
65-69,1189,1381,2570,Giresun,Bulancak
70-74,845,1122,1967,Giresun,Bulancak
75+,1531,2307,3838,Giresun,Bulancak
18-24,340,366,706,Afyonkarahisar,Evciler
25-29,205,185,390,Afyonkarahisar,Evciler
30-34,231,188,419,Afyonkarahisar,Evciler
35-39,275,212,487,Afyonkarahisar,Evciler
40-44,244,226,470,Afyonkarahisar,Evciler
45-49,232,256,488,Afyonkarahisar,Evciler
50-54,264,258,522,Afyonkarahisar,Evciler
55-59,225,250,475,Afyonkarahisar,Evciler
60-64,198,250,448,Afyonkarahisar,Evciler
65-69,180,213,393,Afyonkarahisar,Evciler
70-74,141,184,325,Afyonkarahisar,Evciler
75+,199,295,494,Afyonkarahisar,Evciler
18-24,8109,8977,17086,Iğdır,Iğdır Merkez
25-29,5587,5335,10922,Iğdır,Iğdır Merkez
30-34,5204,4787,9991,Iğdır,Iğdır Merkez
35-39,5001,4635,9636,Iğdır,Iğdır Merkez
40-44,3880,3639,7519,Iğdır,Iğdır Merkez
45-49,3468,2999,6467,Iğdır,Iğdır Merkez
50-54,2762,2723,5485,Iğdır,Iğdır Merkez
55-59,2386,2213,4599,Iğdır,Iğdır Merkez
60-64,1934,2022,3956,Iğdır,Iğdır Merkez
65-69,1274,1516,2790,Iğdır,Iğdır Merkez
70-74,973,1057,2030,Iğdır,Iğdır Merkez
75+,1106,1619,2725,Iğdır,Iğdır Merkez
18-24,681,604,1285,Kars,Akyaka
25-29,385,325,710,Kars,Akyaka
30-34,403,304,707,Kars,Akyaka
35-39,413,387,800,Kars,Akyaka
40-44,366,277,643,Kars,Akyaka
45-49,322,251,573,Kars,Akyaka
50-54,300,260,560,Kars,Akyaka
55-59,268,286,554,Kars,Akyaka
60-64,221,212,433,Kars,Akyaka
65-69,166,176,342,Kars,Akyaka
70-74,167,147,314,Kars,Akyaka
75+,204,258,462,Kars,Akyaka
18-24,431,419,850,Gümüşhane,Köse
25-29,172,188,360,Gümüşhane,Köse
30-34,162,159,321,Gümüşhane,Köse
35-39,170,165,335,Gümüşhane,Köse
40-44,173,177,350,Gümüşhane,Köse
45-49,188,193,381,Gümüşhane,Köse
50-54,192,197,389,Gümüşhane,Köse
55-59,193,197,390,Gümüşhane,Köse
60-64,206,226,432,Gümüşhane,Köse
65-69,185,173,358,Gümüşhane,Köse
70-74,129,164,293,Gümüşhane,Köse
75+,198,302,500,Gümüşhane,Köse
18-24,563,534,1097,Kars,Susuz
25-29,337,307,644,Kars,Susuz
30-34,319,319,638,Kars,Susuz
35-39,367,293,660,Kars,Susuz
40-44,335,272,607,Kars,Susuz
45-49,314,261,575,Kars,Susuz
50-54,310,290,600,Kars,Susuz
55-59,260,281,541,Kars,Susuz
60-64,243,224,467,Kars,Susuz
65-69,179,219,398,Kars,Susuz
70-74,164,186,350,Kars,Susuz
75+,204,280,484,Kars,Susuz
18-24,1424,1428,2852,Ordu,Gölköy
25-29,879,781,1660,Ordu,Gölköy
30-34,827,716,1543,Ordu,Gölköy
35-39,971,826,1797,Ordu,Gölköy
40-44,916,839,1755,Ordu,Gölköy
45-49,931,935,1866,Ordu,Gölköy
50-54,1088,1011,2099,Ordu,Gölköy
55-59,982,1021,2003,Ordu,Gölköy
60-64,850,971,1821,Ordu,Gölköy
65-69,812,879,1691,Ordu,Gölköy
70-74,514,659,1173,Ordu,Gölköy
75+,832,1132,1964,Ordu,Gölköy
18-24,406,387,793,Kütahya,Aslanapa
25-29,208,172,380,Kütahya,Aslanapa
30-34,261,280,541,Kütahya,Aslanapa
35-39,289,285,574,Kütahya,Aslanapa
40-44,315,293,608,Kütahya,Aslanapa
45-49,319,325,644,Kütahya,Aslanapa
50-54,323,334,657,Kütahya,Aslanapa
55-59,351,379,730,Kütahya,Aslanapa
60-64,350,365,715,Kütahya,Aslanapa
65-69,315,341,656,Kütahya,Aslanapa
70-74,216,274,490,Kütahya,Aslanapa
75+,303,410,713,Kütahya,Aslanapa
18-24,490,458,948,Trabzon,Şalpazarı
25-29,256,228,484,Trabzon,Şalpazarı
30-34,260,187,447,Trabzon,Şalpazarı
35-39,262,216,478,Trabzon,Şalpazarı
40-44,256,257,513,Trabzon,Şalpazarı
45-49,311,349,660,Trabzon,Şalpazarı
50-54,416,435,851,Trabzon,Şalpazarı
55-59,461,461,922,Trabzon,Şalpazarı
60-64,475,534,1009,Trabzon,Şalpazarı
65-69,389,428,817,Trabzon,Şalpazarı
70-74,295,392,687,Trabzon,Şalpazarı
75+,576,839,1415,Trabzon,Şalpazarı
18-24,7730,8143,15873,Zonguldak,Ereğli
25-29,5454,5382,10836,Zonguldak,Ereğli
30-34,6324,6532,12856,Zonguldak,Ereğli
35-39,7511,7640,15151,Zonguldak,Ereğli
40-44,7238,7198,14436,Zonguldak,Ereğli
45-49,6183,6212,12395,Zonguldak,Ereğli
50-54,5444,5769,11213,Zonguldak,Ereğli
55-59,4940,5459,10399,Zonguldak,Ereğli
60-64,4281,4644,8925,Zonguldak,Ereğli
65-69,3189,3285,6474,Zonguldak,Ereğli
70-74,1835,2166,4001,Zonguldak,Ereğli
75+,2356,3503,5859,Zonguldak,Ereğli
18-24,2763,2931,5694,Ankara,Kahramankazan
25-29,2164,2202,4366,Ankara,Kahramankazan
30-34,2362,2254,4616,Ankara,Kahramankazan
35-39,2295,2130,4425,Ankara,Kahramankazan
40-44,1965,1728,3693,Ankara,Kahramankazan
45-49,1787,1573,3360,Ankara,Kahramankazan
50-54,1443,1336,2779,Ankara,Kahramankazan
55-59,1205,1092,2297,Ankara,Kahramankazan
60-64,827,811,1638,Ankara,Kahramankazan
65-69,547,658,1205,Ankara,Kahramankazan
70-74,339,422,761,Ankara,Kahramankazan
75+,511,763,1274,Ankara,Kahramankazan
18-24,620,662,1282,Yozgat,Kadışehri
25-29,340,314,654,Yozgat,Kadışehri
30-34,301,305,606,Yozgat,Kadışehri
35-39,321,346,667,Yozgat,Kadışehri
40-44,321,358,679,Yozgat,Kadışehri
45-49,348,295,643,Yozgat,Kadışehri
50-54,334,373,707,Yozgat,Kadışehri
55-59,327,320,647,Yozgat,Kadışehri
60-64,295,307,602,Yozgat,Kadışehri
65-69,266,316,582,Yozgat,Kadışehri
70-74,186,214,400,Yozgat,Kadışehri
75+,189,243,432,Yozgat,Kadışehri
18-24,3633,3709,7342,Kahramanmaraş,Pazarcık
25-29,2256,2250,4506,Kahramanmaraş,Pazarcık
30-34,2524,2281,4805,Kahramanmaraş,Pazarcık
35-39,2399,2274,4673,Kahramanmaraş,Pazarcık
40-44,2175,2217,4392,Kahramanmaraş,Pazarcık
45-49,1894,1903,3797,Kahramanmaraş,Pazarcık
50-54,1611,1732,3343,Kahramanmaraş,Pazarcık
55-59,1358,1371,2729,Kahramanmaraş,Pazarcık
60-64,1283,1361,2644,Kahramanmaraş,Pazarcık
65-69,1157,1196,2353,Kahramanmaraş,Pazarcık
70-74,945,1006,1951,Kahramanmaraş,Pazarcık
75+,1283,1791,3074,Kahramanmaraş,Pazarcık
18-24,4145,4503,8648,Tokat,Turhal
25-29,2220,2425,4645,Tokat,Turhal
30-34,2331,2560,4891,Tokat,Turhal
35-39,2714,2898,5612,Tokat,Turhal
40-44,2559,2723,5282,Tokat,Turhal
45-49,2478,2603,5081,Tokat,Turhal
50-54,2563,2551,5114,Tokat,Turhal
55-59,2354,2731,5085,Tokat,Turhal
60-64,2490,2587,5077,Tokat,Turhal
65-69,1982,2146,4128,Tokat,Turhal
70-74,1346,1613,2959,Tokat,Turhal
75+,1655,2224,3879,Tokat,Turhal
18-24,220,114,334,Tunceli,Pülümür
25-29,195,56,251,Tunceli,Pülümür
30-34,101,77,178,Tunceli,Pülümür
35-39,122,60,182,Tunceli,Pülümür
40-44,118,78,196,Tunceli,Pülümür
45-49,137,86,223,Tunceli,Pülümür
50-54,128,116,244,Tunceli,Pülümür
55-59,147,142,289,Tunceli,Pülümür
60-64,187,149,336,Tunceli,Pülümür
65-69,144,121,265,Tunceli,Pülümür
70-74,91,108,199,Tunceli,Pülümür
75+,152,172,324,Tunceli,Pülümür
18-24,12741,12845,25586,İstanbul,Beykoz
25-29,9277,8970,18247,İstanbul,Beykoz
30-34,9653,9633,19286,İstanbul,Beykoz
35-39,10525,10744,21269,İstanbul,Beykoz
40-44,9644,10031,19675,İstanbul,Beykoz
45-49,9253,9228,18481,İstanbul,Beykoz
50-54,8296,8104,16400,İstanbul,Beykoz
55-59,7238,7107,14345,İstanbul,Beykoz
60-64,5583,5488,11071,İstanbul,Beykoz
65-69,3687,3842,7529,İstanbul,Beykoz
70-74,2167,2666,4833,İstanbul,Beykoz
75+,2920,4592,7512,İstanbul,Beykoz
18-24,344,366,710,Erzincan,İliç
25-29,310,294,604,Erzincan,İliç
30-34,361,273,634,Erzincan,İliç
35-39,322,240,562,Erzincan,İliç
40-44,237,189,426,Erzincan,İliç
45-49,205,187,392,Erzincan,İliç
50-54,230,178,408,Erzincan,İliç
55-59,229,215,444,Erzincan,İliç
60-64,288,252,540,Erzincan,İliç
65-69,195,223,418,Erzincan,İliç
70-74,160,215,375,Erzincan,İliç
75+,358,461,819,Erzincan,İliç
18-24,5427,5733,11160,Şırnak,İdil
25-29,3339,3019,6358,Şırnak,İdil
30-34,2140,2113,4253,Şırnak,İdil
35-39,1796,2030,3826,Şırnak,İdil
40-44,1329,1674,3003,Şırnak,İdil
45-49,1103,1281,2384,Şırnak,İdil
50-54,841,829,1670,Şırnak,İdil
55-59,647,633,1280,Şırnak,İdil
60-64,597,632,1229,Şırnak,İdil
65-69,446,541,987,Şırnak,İdil
70-74,253,390,643,Şırnak,İdil
75+,439,656,1095,Şırnak,İdil
18-24,1650,1750,3400,Uşak,Banaz
25-29,1126,1061,2187,Uşak,Banaz
30-34,1272,1159,2431,Uşak,Banaz
35-39,1336,1176,2512,Uşak,Banaz
40-44,1162,1136,2298,Uşak,Banaz
45-49,1153,1144,2297,Uşak,Banaz
50-54,1221,1205,2426,Uşak,Banaz
55-59,1229,1302,2531,Uşak,Banaz
60-64,1143,1240,2383,Uşak,Banaz
65-69,847,1016,1863,Uşak,Banaz
70-74,612,744,1356,Uşak,Banaz
75+,1024,1386,2410,Uşak,Banaz
18-24,402,419,821,Bilecik,Pazaryeri
25-29,295,264,559,Bilecik,Pazaryeri
30-34,324,239,563,Bilecik,Pazaryeri
35-39,309,273,582,Bilecik,Pazaryeri
40-44,295,259,554,Bilecik,Pazaryeri
45-49,299,308,607,Bilecik,Pazaryeri
50-54,330,367,697,Bilecik,Pazaryeri
55-59,380,372,752,Bilecik,Pazaryeri
60-64,362,425,787,Bilecik,Pazaryeri
65-69,325,329,654,Bilecik,Pazaryeri
70-74,206,293,499,Bilecik,Pazaryeri
75+,416,618,1034,Bilecik,Pazaryeri
18-24,660,744,1404,Burdur,Çavdır
25-29,368,319,687,Burdur,Çavdır
30-34,380,343,723,Burdur,Çavdır
35-39,424,402,826,Burdur,Çavdır
40-44,449,401,850,Burdur,Çavdır
45-49,482,426,908,Burdur,Çavdır
50-54,462,456,918,Burdur,Çavdır
55-59,465,478,943,Burdur,Çavdır
60-64,369,435,804,Burdur,Çavdır
65-69,259,341,600,Burdur,Çavdır
70-74,204,236,440,Burdur,Çavdır
75+,347,516,863,Burdur,Çavdır
18-24,10429,10792,21221,Tokat,Tokat Merkez
25-29,6463,6899,13362,Tokat,Tokat Merkez
30-34,6719,7105,13824,Tokat,Tokat Merkez
35-39,7079,7318,14397,Tokat,Tokat Merkez
40-44,6518,6661,13179,Tokat,Tokat Merkez
45-49,5836,5919,11755,Tokat,Tokat Merkez
50-54,5612,5682,11294,Tokat,Tokat Merkez
55-59,5014,5083,10097,Tokat,Tokat Merkez
60-64,4175,4287,8462,Tokat,Tokat Merkez
65-69,3015,3291,6306,Tokat,Tokat Merkez
70-74,2193,2605,4798,Tokat,Tokat Merkez
75+,2487,3294,5781,Tokat,Tokat Merkez
18-24,397,324,721,Ordu,Kabadüz
25-29,191,132,323,Ordu,Kabadüz
30-34,172,131,303,Ordu,Kabadüz
35-39,198,163,361,Ordu,Kabadüz
40-44,251,190,441,Ordu,Kabadüz
45-49,272,234,506,Ordu,Kabadüz
50-54,365,295,660,Ordu,Kabadüz
55-59,374,282,656,Ordu,Kabadüz
60-64,322,314,636,Ordu,Kabadüz
65-69,251,256,507,Ordu,Kabadüz
70-74,184,196,380,Ordu,Kabadüz
75+,312,398,710,Ordu,Kabadüz
18-24,5809,5866,11675,Samsun,Vezirköprü
25-29,3154,3196,6350,Samsun,Vezirköprü
30-34,3053,3082,6135,Samsun,Vezirköprü
35-39,2985,3101,6086,Samsun,Vezirköprü
40-44,2552,2616,5168,Samsun,Vezirköprü
45-49,2623,2686,5309,Samsun,Vezirköprü
50-54,2569,2794,5363,Samsun,Vezirköprü
55-59,2500,2484,4984,Samsun,Vezirköprü
60-64,2044,2310,4354,Samsun,Vezirköprü
65-69,1685,1855,3540,Samsun,Vezirköprü
70-74,1350,1533,2883,Samsun,Vezirköprü
75+,1547,2006,3553,Samsun,Vezirköprü
18-24,626,679,1305,Trabzon,Çaykara
25-29,417,359,776,Trabzon,Çaykara
30-34,377,292,669,Trabzon,Çaykara
35-39,389,328,717,Trabzon,Çaykara
40-44,350,337,687,Trabzon,Çaykara
45-49,388,375,763,Trabzon,Çaykara
50-54,421,422,843,Trabzon,Çaykara
55-59,450,492,942,Trabzon,Çaykara
60-64,490,536,1026,Trabzon,Çaykara
65-69,440,498,938,Trabzon,Çaykara
70-74,398,450,848,Trabzon,Çaykara
75+,628,917,1545,Trabzon,Çaykara
18-24,685,790,1475,Diyarbakır,Çüngüş
25-29,455,415,870,Diyarbakır,Çüngüş
30-34,410,366,776,Diyarbakır,Çüngüş
35-39,335,337,672,Diyarbakır,Çüngüş
40-44,324,293,617,Diyarbakır,Çüngüş
45-49,322,290,612,Diyarbakır,Çüngüş
50-54,287,288,575,Diyarbakır,Çüngüş
55-59,243,290,533,Diyarbakır,Çüngüş
60-64,235,214,449,Diyarbakır,Çüngüş
65-69,168,236,404,Diyarbakır,Çüngüş
70-74,170,190,360,Diyarbakır,Çüngüş
75+,243,400,643,Diyarbakır,Çüngüş
18-24,12098,12448,24546,Tekirdağ,Çorlu
25-29,10320,10389,20709,Tekirdağ,Çorlu
30-34,11812,11729,23541,Tekirdağ,Çorlu
35-39,13515,12869,26384,Tekirdağ,Çorlu
40-44,11644,10694,22338,Tekirdağ,Çorlu
45-49,9544,8755,18299,Tekirdağ,Çorlu
50-54,7531,7189,14720,Tekirdağ,Çorlu
55-59,5941,5914,11855,Tekirdağ,Çorlu
60-64,4621,4860,9481,Tekirdağ,Çorlu
65-69,3165,3499,6664,Tekirdağ,Çorlu
70-74,1840,2318,4158,Tekirdağ,Çorlu
75+,2076,3018,5094,Tekirdağ,Çorlu
18-24,965,914,1879,Tokat,Almus
25-29,459,447,906,Tokat,Almus
30-34,527,440,967,Tokat,Almus
35-39,510,457,967,Tokat,Almus
40-44,505,521,1026,Tokat,Almus
45-49,530,513,1043,Tokat,Almus
50-54,649,714,1363,Tokat,Almus
55-59,757,760,1517,Tokat,Almus
60-64,820,868,1688,Tokat,Almus
65-69,726,905,1631,Tokat,Almus
70-74,623,663,1286,Tokat,Almus
75+,787,995,1782,Tokat,Almus
18-24,6188,6353,12541,Balıkesir,Edremit
25-29,4348,4342,8690,Balıkesir,Edremit
30-34,4649,4923,9572,Balıkesir,Edremit
35-39,5134,5559,10693,Balıkesir,Edremit
40-44,4930,5462,10392,Balıkesir,Edremit
45-49,4875,5336,10211,Balıkesir,Edremit
50-54,4962,5748,10710,Balıkesir,Edremit
55-59,5521,6444,11965,Balıkesir,Edremit
60-64,5736,6184,11920,Balıkesir,Edremit
65-69,4979,5000,9979,Balıkesir,Edremit
70-74,3579,3342,6921,Balıkesir,Edremit
75+,3851,4317,8168,Balıkesir,Edremit
18-24,844,850,1694,Manisa,Ahmetli
25-29,537,473,1010,Manisa,Ahmetli
30-34,500,439,939,Manisa,Ahmetli
35-39,515,513,1028,Manisa,Ahmetli
40-44,513,522,1035,Manisa,Ahmetli
45-49,535,603,1138,Manisa,Ahmetli
50-54,620,583,1203,Manisa,Ahmetli
55-59,616,556,1172,Manisa,Ahmetli
60-64,533,565,1098,Manisa,Ahmetli
65-69,390,429,819,Manisa,Ahmetli
70-74,268,333,601,Manisa,Ahmetli
75+,401,540,941,Manisa,Ahmetli
18-24,246,239,485,Edirne,Lalapaşa
25-29,175,141,316,Edirne,Lalapaşa
30-34,159,141,300,Edirne,Lalapaşa
35-39,238,149,387,Edirne,Lalapaşa
40-44,203,199,402,Edirne,Lalapaşa
45-49,238,214,452,Edirne,Lalapaşa
50-54,268,265,533,Edirne,Lalapaşa
55-59,328,276,604,Edirne,Lalapaşa
60-64,284,284,568,Edirne,Lalapaşa
65-69,229,204,433,Edirne,Lalapaşa
70-74,131,158,289,Edirne,Lalapaşa
75+,261,343,604,Edirne,Lalapaşa
18-24,6773,7138,13911,Kocaeli,Derince
25-29,5299,5410,10709,Kocaeli,Derince
30-34,5832,5789,11621,Kocaeli,Derince
35-39,6265,6502,12767,Kocaeli,Derince
40-44,5729,5465,11194,Kocaeli,Derince
45-49,4728,4750,9478,Kocaeli,Derince
50-54,4153,4334,8487,Kocaeli,Derince
55-59,3650,3768,7418,Kocaeli,Derince
60-64,3160,3263,6423,Kocaeli,Derince
65-69,2264,2270,4534,Kocaeli,Derince
70-74,1409,1548,2957,Kocaeli,Derince
75+,1479,2096,3575,Kocaeli,Derince
18-24,345,267,612,Burdur,Karamanlı
25-29,247,247,494,Burdur,Karamanlı
30-34,272,217,489,Burdur,Karamanlı
35-39,286,241,527,Burdur,Karamanlı
40-44,274,234,508,Burdur,Karamanlı
45-49,236,208,444,Burdur,Karamanlı
50-54,239,247,486,Burdur,Karamanlı
55-59,271,292,563,Burdur,Karamanlı
60-64,263,271,534,Burdur,Karamanlı
65-69,211,254,465,Burdur,Karamanlı
70-74,168,234,402,Burdur,Karamanlı
75+,326,502,828,Burdur,Karamanlı
18-24,2223,2311,4534,Ankara,Beypazarı
25-29,1590,1591,3181,Ankara,Beypazarı
30-34,1923,1769,3692,Ankara,Beypazarı
35-39,1809,1919,3728,Ankara,Beypazarı
40-44,1704,1624,3328,Ankara,Beypazarı
45-49,1615,1583,3198,Ankara,Beypazarı
50-54,1533,1574,3107,Ankara,Beypazarı
55-59,1513,1587,3100,Ankara,Beypazarı
60-64,1324,1275,2599,Ankara,Beypazarı
65-69,1017,1073,2090,Ankara,Beypazarı
70-74,606,824,1430,Ankara,Beypazarı
75+,1115,1653,2768,Ankara,Beypazarı
18-24,277,284,561,Giresun,Çanakçı
25-29,144,129,273,Giresun,Çanakçı
30-34,154,125,279,Giresun,Çanakçı
35-39,186,140,326,Giresun,Çanakçı
40-44,158,146,304,Giresun,Çanakçı
45-49,219,175,394,Giresun,Çanakçı
50-54,218,214,432,Giresun,Çanakçı
55-59,239,260,499,Giresun,Çanakçı
60-64,281,276,557,Giresun,Çanakçı
65-69,192,190,382,Giresun,Çanakçı
70-74,123,166,289,Giresun,Çanakçı
75+,242,404,646,Giresun,Çanakçı
18-24,241,250,491,Denizli,Baklan
25-29,152,121,273,Denizli,Baklan
30-34,146,132,278,Denizli,Baklan
35-39,205,141,346,Denizli,Baklan
40-44,195,171,366,Denizli,Baklan
45-49,202,172,374,Denizli,Baklan
50-54,194,162,356,Denizli,Baklan
55-59,177,187,364,Denizli,Baklan
60-64,150,168,318,Denizli,Baklan
65-69,185,213,398,Denizli,Baklan
70-74,116,205,321,Denizli,Baklan
75+,232,356,588,Denizli,Baklan
18-24,2450,2465,4915,Edirne,Uzunköprü
25-29,1714,1568,3282,Edirne,Uzunköprü
30-34,1762,1645,3407,Edirne,Uzunköprü
35-39,1868,1798,3666,Edirne,Uzunköprü
40-44,1966,1924,3890,Edirne,Uzunköprü
45-49,2052,2046,4098,Edirne,Uzunköprü
50-54,2275,2461,4736,Edirne,Uzunköprü
55-59,2671,2615,5286,Edirne,Uzunköprü
60-64,2378,2369,4747,Edirne,Uzunköprü
65-69,1951,1984,3935,Edirne,Uzunköprü
70-74,1216,1467,2683,Edirne,Uzunköprü
75+,1804,2763,4567,Edirne,Uzunköprü
18-24,2687,2373,5060,Diyarbakır,Hani
25-29,1508,1193,2701,Diyarbakır,Hani
30-34,1055,952,2007,Diyarbakır,Hani
35-39,894,896,1790,Diyarbakır,Hani
40-44,688,681,1369,Diyarbakır,Hani
45-49,635,629,1264,Diyarbakır,Hani
50-54,500,499,999,Diyarbakır,Hani
55-59,390,393,783,Diyarbakır,Hani
60-64,358,367,725,Diyarbakır,Hani
65-69,288,384,672,Diyarbakır,Hani
70-74,224,272,496,Diyarbakır,Hani
75+,352,505,857,Diyarbakır,Hani
18-24,2827,2856,5683,Adıyaman,Gölbaşı
25-29,1555,1613,3168,Adıyaman,Gölbaşı
30-34,1814,1672,3486,Adıyaman,Gölbaşı
35-39,1792,1828,3620,Adıyaman,Gölbaşı
40-44,1664,1660,3324,Adıyaman,Gölbaşı
45-49,1472,1483,2955,Adıyaman,Gölbaşı
50-54,1357,1269,2626,Adıyaman,Gölbaşı
55-59,1227,1133,2360,Adıyaman,Gölbaşı
60-64,970,972,1942,Adıyaman,Gölbaşı
65-69,789,915,1704,Adıyaman,Gölbaşı
70-74,581,686,1267,Adıyaman,Gölbaşı
75+,874,1193,2067,Adıyaman,Gölbaşı
18-24,405,394,799,Eskişehir,Mahmudiye
25-29,218,213,431,Eskişehir,Mahmudiye
30-34,231,199,430,Eskişehir,Mahmudiye
35-39,235,209,444,Eskişehir,Mahmudiye
40-44,226,252,478,Eskişehir,Mahmudiye
45-49,256,221,477,Eskişehir,Mahmudiye
50-54,256,243,499,Eskişehir,Mahmudiye
55-59,273,251,524,Eskişehir,Mahmudiye
60-64,224,228,452,Eskişehir,Mahmudiye
65-69,194,205,399,Eskişehir,Mahmudiye
70-74,133,183,316,Eskişehir,Mahmudiye
75+,221,294,515,Eskişehir,Mahmudiye
18-24,303,328,631,Çankırı,Kurşunlu
25-29,255,178,433,Çankırı,Kurşunlu
30-34,251,212,463,Çankırı,Kurşunlu
35-39,234,198,432,Çankırı,Kurşunlu
40-44,222,196,418,Çankırı,Kurşunlu
45-49,255,254,509,Çankırı,Kurşunlu
50-54,312,292,604,Çankırı,Kurşunlu
55-59,340,336,676,Çankırı,Kurşunlu
60-64,315,298,613,Çankırı,Kurşunlu
65-69,268,298,566,Çankırı,Kurşunlu
70-74,232,243,475,Çankırı,Kurşunlu
75+,367,437,804,Çankırı,Kurşunlu
18-24,7954,8154,16108,Manisa,Salihli
25-29,5150,5039,10189,Manisa,Salihli
30-34,5293,5398,10691,Manisa,Salihli
35-39,5677,5895,11572,Manisa,Salihli
40-44,5665,5811,11476,Manisa,Salihli
45-49,5738,6025,11763,Manisa,Salihli
50-54,5792,5888,11680,Manisa,Salihli
55-59,5446,5535,10981,Manisa,Salihli
60-64,4851,4908,9759,Manisa,Salihli
65-69,3416,3924,7340,Manisa,Salihli
70-74,2314,2713,5027,Manisa,Salihli
75+,2949,4366,7315,Manisa,Salihli
18-24,864,749,1613,Muğla,Datça
25-29,571,525,1096,Muğla,Datça
30-34,613,646,1259,Muğla,Datça
35-39,777,783,1560,Muğla,Datça
40-44,774,685,1459,Muğla,Datça
45-49,773,787,1560,Muğla,Datça
50-54,796,838,1634,Muğla,Datça
55-59,850,905,1755,Muğla,Datça
60-64,911,897,1808,Muğla,Datça
65-69,789,750,1539,Muğla,Datça
70-74,625,561,1186,Muğla,Datça
75+,911,1041,1952,Muğla,Datça
18-24,1447,1289,2736,Konya,Bozkır
25-29,743,623,1366,Konya,Bozkır
30-34,749,686,1435,Konya,Bozkır
35-39,803,690,1493,Konya,Bozkır
40-44,719,774,1493,Konya,Bozkır
45-49,744,752,1496,Konya,Bozkır
50-54,767,798,1565,Konya,Bozkır
55-59,738,864,1602,Konya,Bozkır
60-64,678,753,1431,Konya,Bozkır
65-69,551,689,1240,Konya,Bozkır
70-74,494,755,1249,Konya,Bozkır
75+,999,1435,2434,Konya,Bozkır
18-24,830,760,1590,Ordu,İkizce
25-29,422,326,748,Ordu,İkizce
30-34,380,367,747,Ordu,İkizce
35-39,430,381,811,Ordu,İkizce
40-44,429,416,845,Ordu,İkizce
45-49,451,388,839,Ordu,İkizce
50-54,524,513,1037,Ordu,İkizce
55-59,511,471,982,Ordu,İkizce
60-64,481,482,963,Ordu,İkizce
65-69,393,378,771,Ordu,İkizce
70-74,291,315,606,Ordu,İkizce
75+,353,514,867,Ordu,İkizce
18-24,244,208,452,Giresun,Çamoluk
25-29,140,99,239,Giresun,Çamoluk
30-34,148,123,271,Giresun,Çamoluk
35-39,154,128,282,Giresun,Çamoluk
40-44,134,93,227,Giresun,Çamoluk
45-49,158,137,295,Giresun,Çamoluk
50-54,211,197,408,Giresun,Çamoluk
55-59,306,327,633,Giresun,Çamoluk
60-64,417,418,835,Giresun,Çamoluk
65-69,334,370,704,Giresun,Çamoluk
70-74,214,288,502,Giresun,Çamoluk
75+,423,489,912,Giresun,Çamoluk
18-24,17359,18017,35376,Şanlıurfa,Siverek
25-29,10392,10615,21007,Şanlıurfa,Siverek
30-34,8243,8066,16309,Şanlıurfa,Siverek
35-39,7061,6958,14019,Şanlıurfa,Siverek
40-44,5675,5815,11490,Şanlıurfa,Siverek
45-49,4718,4729,9447,Şanlıurfa,Siverek
50-54,4046,3840,7886,Şanlıurfa,Siverek
55-59,2909,3120,6029,Şanlıurfa,Siverek
60-64,1883,2133,4016,Şanlıurfa,Siverek
65-69,1567,1832,3399,Şanlıurfa,Siverek
70-74,1040,1301,2341,Şanlıurfa,Siverek
75+,1357,2259,3616,Şanlıurfa,Siverek
18-24,62,76,138,Rize,Hemşin
25-29,47,52,99,Rize,Hemşin
30-34,66,35,101,Rize,Hemşin
35-39,52,46,98,Rize,Hemşin
40-44,65,50,115,Rize,Hemşin
45-49,68,69,137,Rize,Hemşin
50-54,101,100,201,Rize,Hemşin
55-59,106,121,227,Rize,Hemşin
60-64,145,153,298,Rize,Hemşin
65-69,109,115,224,Rize,Hemşin
70-74,93,103,196,Rize,Hemşin
75+,114,225,339,Rize,Hemşin
18-24,113,89,202,Sivas,Doğanşar
25-29,75,54,129,Sivas,Doğanşar
30-34,49,43,92,Sivas,Doğanşar
35-39,49,45,94,Sivas,Doğanşar
40-44,63,64,127,Sivas,Doğanşar
45-49,42,79,121,Sivas,Doğanşar
50-54,77,91,168,Sivas,Doğanşar
55-59,118,133,251,Sivas,Doğanşar
60-64,169,189,358,Sivas,Doğanşar
65-69,156,174,330,Sivas,Doğanşar
70-74,149,164,313,Sivas,Doğanşar
75+,161,208,369,Sivas,Doğanşar
18-24,3977,3995,7972,Çanakkale,Biga
25-29,2898,2775,5673,Çanakkale,Biga
30-34,3106,2885,5991,Çanakkale,Biga
35-39,3613,3316,6929,Çanakkale,Biga
40-44,3163,2974,6137,Çanakkale,Biga
45-49,2994,2891,5885,Çanakkale,Biga
50-54,2960,2940,5900,Çanakkale,Biga
55-59,2942,2951,5893,Çanakkale,Biga
60-64,2545,2745,5290,Çanakkale,Biga
65-69,2331,2389,4720,Çanakkale,Biga
70-74,1480,1748,3228,Çanakkale,Biga
75+,2251,3169,5420,Çanakkale,Biga
18-24,239,237,476,Çankırı,Eldivan
25-29,149,111,260,Çankırı,Eldivan
30-34,171,111,282,Çankırı,Eldivan
35-39,146,109,255,Çankırı,Eldivan
40-44,159,138,297,Çankırı,Eldivan
45-49,162,173,335,Çankırı,Eldivan
50-54,219,217,436,Çankırı,Eldivan
55-59,243,256,499,Çankırı,Eldivan
60-64,249,266,515,Çankırı,Eldivan
65-69,202,235,437,Çankırı,Eldivan
70-74,153,184,337,Çankırı,Eldivan
75+,295,412,707,Çankırı,Eldivan
18-24,14162,16039,30201,Aksaray,Aksaray Merkez
25-29,9980,10108,20088,Aksaray,Aksaray Merkez
30-34,10965,10842,21807,Aksaray,Aksaray Merkez
35-39,11313,10956,22269,Aksaray,Aksaray Merkez
40-44,9501,9682,19183,Aksaray,Aksaray Merkez
45-49,8245,8590,16835,Aksaray,Aksaray Merkez
50-54,7176,7257,14433,Aksaray,Aksaray Merkez
55-59,5680,6205,11885,Aksaray,Aksaray Merkez
60-64,4571,4990,9561,Aksaray,Aksaray Merkez
65-69,3968,4422,8390,Aksaray,Aksaray Merkez
70-74,2481,3075,5556,Aksaray,Aksaray Merkez
75+,2992,4535,7527,Aksaray,Aksaray Merkez
18-24,1221,1218,2439,Ordu,Aybastı
25-29,664,627,1291,Ordu,Aybastı
30-34,676,590,1266,Ordu,Aybastı
35-39,729,697,1426,Ordu,Aybastı
40-44,708,634,1342,Ordu,Aybastı
45-49,740,714,1454,Ordu,Aybastı
50-54,659,706,1365,Ordu,Aybastı
55-59,641,675,1316,Ordu,Aybastı
60-64,619,732,1351,Ordu,Aybastı
65-69,496,653,1149,Ordu,Aybastı
70-74,401,447,848,Ordu,Aybastı
75+,690,905,1595,Ordu,Aybastı
18-24,525,463,988,Eskişehir,Seyitgazi
25-29,339,287,626,Eskişehir,Seyitgazi
30-34,425,310,735,Eskişehir,Seyitgazi
35-39,365,329,694,Eskişehir,Seyitgazi
40-44,413,367,780,Eskişehir,Seyitgazi
45-49,462,424,886,Eskişehir,Seyitgazi
50-54,537,506,1043,Eskişehir,Seyitgazi
55-59,599,560,1159,Eskişehir,Seyitgazi
60-64,459,481,940,Eskişehir,Seyitgazi
65-69,448,440,888,Eskişehir,Seyitgazi
70-74,323,403,726,Eskişehir,Seyitgazi
75+,559,769,1328,Eskişehir,Seyitgazi
18-24,1133,1138,2271,Aksaray,Gülağaç
25-29,663,566,1229,Aksaray,Gülağaç
30-34,688,526,1214,Aksaray,Gülağaç
35-39,619,559,1178,Aksaray,Gülağaç
40-44,565,547,1112,Aksaray,Gülağaç
45-49,591,600,1191,Aksaray,Gülağaç
50-54,527,582,1109,Aksaray,Gülağaç
55-59,498,544,1042,Aksaray,Gülağaç
60-64,444,474,918,Aksaray,Gülağaç
65-69,374,421,795,Aksaray,Gülağaç
70-74,285,353,638,Aksaray,Gülağaç
75+,372,497,869,Aksaray,Gülağaç
18-24,5154,5486,10640,Bursa,Gemlik
25-29,3876,3781,7657,Bursa,Gemlik
30-34,4149,4072,8221,Bursa,Gemlik
35-39,4608,4571,9179,Bursa,Gemlik
40-44,4172,4147,8319,Bursa,Gemlik
45-49,3696,3705,7401,Bursa,Gemlik
50-54,3504,3634,7138,Bursa,Gemlik
55-59,3145,3367,6512,Bursa,Gemlik
60-64,2854,2891,5745,Bursa,Gemlik
65-69,2210,2199,4409,Bursa,Gemlik
70-74,1305,1556,2861,Bursa,Gemlik
75+,1742,2342,4084,Bursa,Gemlik
18-24,27793,29503,57296,Ankara,Sincan
25-29,20593,21465,42058,Ankara,Sincan
30-34,22311,22039,44350,Ankara,Sincan
35-39,22959,22333,45292,Ankara,Sincan
40-44,19842,19110,38952,Ankara,Sincan
45-49,17208,16719,33927,Ankara,Sincan
50-54,14518,14368,28886,Ankara,Sincan
55-59,12601,12224,24825,Ankara,Sincan
60-64,9113,9316,18429,Ankara,Sincan
65-69,6027,6170,12197,Ankara,Sincan
70-74,3251,3779,7030,Ankara,Sincan
75+,3301,5179,8480,Ankara,Sincan
18-24,2646,2615,5261,Antalya,Kaş
25-29,1901,1766,3667,Antalya,Kaş
30-34,2149,1921,4070,Antalya,Kaş
35-39,2294,2204,4498,Antalya,Kaş
40-44,2236,1999,4235,Antalya,Kaş
45-49,2407,2171,4578,Antalya,Kaş
50-54,2101,1911,4012,Antalya,Kaş
55-59,1848,1630,3478,Antalya,Kaş
60-64,1361,1284,2645,Antalya,Kaş
65-69,988,1101,2089,Antalya,Kaş
70-74,790,884,1674,Antalya,Kaş
75+,1360,1580,2940,Antalya,Kaş
18-24,1520,1482,3002,Kars,Digor
25-29,950,850,1800,Kars,Digor
30-34,753,620,1373,Kars,Digor
35-39,725,720,1445,Kars,Digor
40-44,645,517,1162,Kars,Digor
45-49,520,476,996,Kars,Digor
50-54,423,428,851,Kars,Digor
55-59,402,372,774,Kars,Digor
60-64,367,348,715,Kars,Digor
65-69,229,274,503,Kars,Digor
70-74,252,254,506,Kars,Digor
75+,268,336,604,Kars,Digor
18-24,6527,6886,13413,Ordu,Ünye
25-29,3878,4105,7983,Ordu,Ünye
30-34,4096,4113,8209,Ordu,Ünye
35-39,4429,4657,9086,Ordu,Ünye
40-44,4331,4323,8654,Ordu,Ünye
45-49,3913,3944,7857,Ordu,Ünye
50-54,4086,4065,8151,Ordu,Ünye
55-59,3714,3689,7403,Ordu,Ünye
60-64,3253,3416,6669,Ordu,Ünye
65-69,2612,2627,5239,Ordu,Ünye
70-74,1759,2018,3777,Ordu,Ünye
75+,2342,3449,5791,Ordu,Ünye
18-24,1989,2181,4170,Zonguldak,Alaplı
25-29,1419,1445,2864,Zonguldak,Alaplı
30-34,1593,1472,3065,Zonguldak,Alaplı
35-39,1661,1648,3309,Zonguldak,Alaplı
40-44,1592,1553,3145,Zonguldak,Alaplı
45-49,1462,1485,2947,Zonguldak,Alaplı
50-54,1370,1527,2897,Zonguldak,Alaplı
55-59,1396,1459,2855,Zonguldak,Alaplı
60-64,1225,1381,2606,Zonguldak,Alaplı
65-69,860,945,1805,Zonguldak,Alaplı
70-74,526,595,1121,Zonguldak,Alaplı
75+,698,998,1696,Zonguldak,Alaplı
18-24,549,542,1091,Ordu,Kabataş
25-29,244,240,484,Ordu,Kabataş
30-34,277,230,507,Ordu,Kabataş
35-39,337,302,639,Ordu,Kabataş
40-44,345,291,636,Ordu,Kabataş
45-49,358,373,731,Ordu,Kabataş
50-54,389,417,806,Ordu,Kabataş
55-59,352,386,738,Ordu,Kabataş
60-64,357,445,802,Ordu,Kabataş
65-69,248,340,588,Ordu,Kabataş
70-74,217,225,442,Ordu,Kabataş
75+,351,439,790,Ordu,Kabataş
18-24,1220,1289,2509,Sakarya,Ferizli
25-29,972,941,1913,Sakarya,Ferizli
30-34,952,843,1795,Sakarya,Ferizli
35-39,1002,857,1859,Sakarya,Ferizli
40-44,888,772,1660,Sakarya,Ferizli
45-49,798,837,1635,Sakarya,Ferizli
50-54,831,767,1598,Sakarya,Ferizli
55-59,740,698,1438,Sakarya,Ferizli
60-64,674,678,1352,Sakarya,Ferizli
65-69,492,472,964,Sakarya,Ferizli
70-74,321,333,654,Sakarya,Ferizli
75+,435,639,1074,Sakarya,Ferizli
18-24,257,199,456,Isparta,Aksu
25-29,131,80,211,Isparta,Aksu
30-34,115,82,197,Isparta,Aksu
35-39,111,91,202,Isparta,Aksu
40-44,124,96,220,Isparta,Aksu
45-49,148,136,284,Isparta,Aksu
50-54,138,145,283,Isparta,Aksu
55-59,149,159,308,Isparta,Aksu
60-64,134,162,296,Isparta,Aksu
65-69,137,194,331,Isparta,Aksu
70-74,135,167,302,Isparta,Aksu
75+,269,305,574,Isparta,Aksu
18-24,2931,2795,5726,Diyarbakır,Dicle
25-29,1546,1267,2813,Diyarbakır,Dicle
30-34,1052,1052,2104,Diyarbakır,Dicle
35-39,971,1081,2052,Diyarbakır,Dicle
40-44,841,888,1729,Diyarbakır,Dicle
45-49,799,808,1607,Diyarbakır,Dicle
50-54,624,619,1243,Diyarbakır,Dicle
55-59,583,572,1155,Diyarbakır,Dicle
60-64,412,518,930,Diyarbakır,Dicle
65-69,375,507,882,Diyarbakır,Dicle
70-74,359,418,777,Diyarbakır,Dicle
75+,578,798,1376,Diyarbakır,Dicle
18-24,428,447,875,Artvin,Kemalpaşa
25-29,263,302,565,Artvin,Kemalpaşa
30-34,317,294,611,Artvin,Kemalpaşa
35-39,330,275,605,Artvin,Kemalpaşa
40-44,322,275,597,Artvin,Kemalpaşa
45-49,370,320,690,Artvin,Kemalpaşa
50-54,322,292,614,Artvin,Kemalpaşa
55-59,300,276,576,Artvin,Kemalpaşa
60-64,235,266,501,Artvin,Kemalpaşa
65-69,158,196,354,Artvin,Kemalpaşa
70-74,126,184,310,Artvin,Kemalpaşa
75+,169,281,450,Artvin,Kemalpaşa
18-24,6633,6711,13344,Yalova,Yalova Merkez
25-29,4711,4512,9223,Yalova,Yalova Merkez
30-34,4813,4681,9494,Yalova,Yalova Merkez
35-39,4949,5403,10352,Yalova,Yalova Merkez
40-44,4756,4982,9738,Yalova,Yalova Merkez
45-49,4526,4725,9251,Yalova,Yalova Merkez
50-54,4076,4267,8343,Yalova,Yalova Merkez
55-59,3916,3938,7854,Yalova,Yalova Merkez
60-64,3150,3327,6477,Yalova,Yalova Merkez
65-69,2363,2526,4889,Yalova,Yalova Merkez
70-74,1537,1900,3437,Yalova,Yalova Merkez
75+,2179,3076,5255,Yalova,Yalova Merkez
18-24,486,435,921,Artvin,Ardanuç
25-29,312,285,597,Artvin,Ardanuç
30-34,304,260,564,Artvin,Ardanuç
35-39,322,269,591,Artvin,Ardanuç
40-44,287,272,559,Artvin,Ardanuç
45-49,381,376,757,Artvin,Ardanuç
50-54,423,432,855,Artvin,Ardanuç
55-59,469,402,871,Artvin,Ardanuç
60-64,463,477,940,Artvin,Ardanuç
65-69,364,405,769,Artvin,Ardanuç
70-74,245,344,589,Artvin,Ardanuç
75+,532,651,1183,Artvin,Ardanuç
18-24,5840,5802,11642,Hakkari,Hakkari Merkez
25-29,5353,3777,9130,Hakkari,Hakkari Merkez
30-34,3199,2738,5937,Hakkari,Hakkari Merkez
35-39,2785,2736,5521,Hakkari,Hakkari Merkez
40-44,2229,2067,4296,Hakkari,Hakkari Merkez
45-49,1759,1466,3225,Hakkari,Hakkari Merkez
50-54,1356,1113,2469,Hakkari,Hakkari Merkez
55-59,984,941,1925,Hakkari,Hakkari Merkez
60-64,806,925,1731,Hakkari,Hakkari Merkez
65-69,482,675,1157,Hakkari,Hakkari Merkez
70-74,276,400,676,Hakkari,Hakkari Merkez
75+,404,570,974,Hakkari,Hakkari Merkez
18-24,8791,9094,17885,Tekirdağ,Süleymanpaşa
25-29,7104,6801,13905,Tekirdağ,Süleymanpaşa
30-34,7251,7188,14439,Tekirdağ,Süleymanpaşa
35-39,8088,8094,16182,Tekirdağ,Süleymanpaşa
40-44,7370,7322,14692,Tekirdağ,Süleymanpaşa
45-49,6985,6902,13887,Tekirdağ,Süleymanpaşa
50-54,6572,6651,13223,Tekirdağ,Süleymanpaşa
55-59,5837,6219,12056,Tekirdağ,Süleymanpaşa
60-64,5063,5422,10485,Tekirdağ,Süleymanpaşa
65-69,3727,3970,7697,Tekirdağ,Süleymanpaşa
70-74,2369,2590,4959,Tekirdağ,Süleymanpaşa
75+,2911,4182,7093,Tekirdağ,Süleymanpaşa
18-24,7491,8161,15652,Rize,Rize Merkez
25-29,5223,5493,10716,Rize,Rize Merkez
30-34,5384,5697,11081,Rize,Rize Merkez
35-39,5682,5767,11449,Rize,Rize Merkez
40-44,5324,5287,10611,Rize,Rize Merkez
45-49,5317,5109,10426,Rize,Rize Merkez
50-54,4742,4605,9347,Rize,Rize Merkez
55-59,4094,3901,7995,Rize,Rize Merkez
60-64,3320,3250,6570,Rize,Rize Merkez
65-69,2127,2251,4378,Rize,Rize Merkez
70-74,1496,1816,3312,Rize,Rize Merkez
75+,1716,3430,5146,Rize,Rize Merkez
18-24,15881,16696,32577,Mersin,Akdeniz
25-29,10801,10412,21213,Mersin,Akdeniz
30-34,9648,9107,18755,Mersin,Akdeniz
35-39,9465,9318,18783,Mersin,Akdeniz
40-44,8043,8144,16187,Mersin,Akdeniz
45-49,7452,7571,15023,Mersin,Akdeniz
50-54,7050,6829,13879,Mersin,Akdeniz
55-59,5893,5928,11821,Mersin,Akdeniz
60-64,4680,4727,9407,Mersin,Akdeniz
65-69,3167,3688,6855,Mersin,Akdeniz
70-74,2023,2697,4720,Mersin,Akdeniz
75+,2628,4159,6787,Mersin,Akdeniz
18-24,5773,6083,11856,Kocaeli,Kartepe
25-29,4375,4480,8855,Kocaeli,Kartepe
30-34,4921,4757,9678,Kocaeli,Kartepe
35-39,5235,5022,10257,Kocaeli,Kartepe
40-44,4680,4253,8933,Kocaeli,Kartepe
45-49,3938,3724,7662,Kocaeli,Kartepe
50-54,3331,3221,6552,Kocaeli,Kartepe
55-59,2752,2695,5447,Kocaeli,Kartepe
60-64,2184,2275,4459,Kocaeli,Kartepe
65-69,1555,1613,3168,Kocaeli,Kartepe
70-74,1035,1158,2193,Kocaeli,Kartepe
75+,1185,1677,2862,Kocaeli,Kartepe
18-24,2146,2259,4405,Sinop,Boyabat
25-29,1428,1463,2891,Sinop,Boyabat
30-34,1572,1450,3022,Sinop,Boyabat
35-39,1372,1439,2811,Sinop,Boyabat
40-44,1321,1227,2548,Sinop,Boyabat
45-49,1186,1188,2374,Sinop,Boyabat
50-54,1226,1213,2439,Sinop,Boyabat
55-59,1317,1346,2663,Sinop,Boyabat
60-64,1235,1284,2519,Sinop,Boyabat
65-69,1068,1098,2166,Sinop,Boyabat
70-74,795,961,1756,Sinop,Boyabat
75+,1339,1713,3052,Sinop,Boyabat
18-24,2467,2421,4888,Bitlis,Hizan
25-29,1158,1035,2193,Bitlis,Hizan
30-34,926,856,1782,Bitlis,Hizan
35-39,829,947,1776,Bitlis,Hizan
40-44,750,730,1480,Bitlis,Hizan
45-49,696,642,1338,Bitlis,Hizan
50-54,667,585,1252,Bitlis,Hizan
55-59,602,534,1136,Bitlis,Hizan
60-64,435,590,1025,Bitlis,Hizan
65-69,417,503,920,Bitlis,Hizan
70-74,282,376,658,Bitlis,Hizan
75+,414,493,907,Bitlis,Hizan
18-24,10363,11024,21387,Erzurum,Yakutiye
25-29,6815,7222,14037,Erzurum,Yakutiye
30-34,6848,6869,13717,Erzurum,Yakutiye
35-39,6598,6726,13324,Erzurum,Yakutiye
40-44,5710,5808,11518,Erzurum,Yakutiye
45-49,5207,5094,10301,Erzurum,Yakutiye
50-54,4526,4353,8879,Erzurum,Yakutiye
55-59,3592,3437,7029,Erzurum,Yakutiye
60-64,2736,2869,5605,Erzurum,Yakutiye
65-69,1849,2010,3859,Erzurum,Yakutiye
70-74,1287,1626,2913,Erzurum,Yakutiye
75+,1646,2495,4141,Erzurum,Yakutiye
18-24,818,747,1565,Malatya,Hekimhan
25-29,462,461,923,Malatya,Hekimhan
30-34,474,369,843,Malatya,Hekimhan
35-39,512,427,939,Malatya,Hekimhan
40-44,474,455,929,Malatya,Hekimhan
45-49,545,525,1070,Malatya,Hekimhan
50-54,646,636,1282,Malatya,Hekimhan
55-59,691,685,1376,Malatya,Hekimhan
60-64,756,661,1417,Malatya,Hekimhan
65-69,670,688,1358,Malatya,Hekimhan
70-74,425,582,1007,Malatya,Hekimhan
75+,809,1217,2026,Malatya,Hekimhan
18-24,21085,21175,42260,Antalya,Muratpaşa
25-29,15763,16909,32672,Antalya,Muratpaşa
30-34,18832,19653,38485,Antalya,Muratpaşa
35-39,21213,22249,43462,Antalya,Muratpaşa
40-44,19454,20713,40167,Antalya,Muratpaşa
45-49,17310,18416,35726,Antalya,Muratpaşa
50-54,14920,15763,30683,Antalya,Muratpaşa
55-59,13350,14008,27358,Antalya,Muratpaşa
60-64,10889,11710,22599,Antalya,Muratpaşa
65-69,7847,8655,16502,Antalya,Muratpaşa
70-74,5239,5934,11173,Antalya,Muratpaşa
75+,5963,8198,14161,Antalya,Muratpaşa
18-24,2255,2198,4453,Isparta,Yalvaç
25-29,1368,1244,2612,Isparta,Yalvaç
30-34,1562,1404,2966,Isparta,Yalvaç
35-39,1533,1510,3043,Isparta,Yalvaç
40-44,1433,1404,2837,Isparta,Yalvaç
45-49,1455,1488,2943,Isparta,Yalvaç
50-54,1306,1469,2775,Isparta,Yalvaç
55-59,1529,1599,3128,Isparta,Yalvaç
60-64,1292,1501,2793,Isparta,Yalvaç
65-69,1133,1246,2379,Isparta,Yalvaç
70-74,876,1124,2000,Isparta,Yalvaç
75+,1229,1813,3042,Isparta,Yalvaç
18-24,1746,1983,3729,Erzurum,Pasinler
25-29,1003,973,1976,Erzurum,Pasinler
30-34,1052,896,1948,Erzurum,Pasinler
35-39,988,1034,2022,Erzurum,Pasinler
40-44,902,798,1700,Erzurum,Pasinler
45-49,882,761,1643,Erzurum,Pasinler
50-54,683,603,1286,Erzurum,Pasinler
55-59,522,507,1029,Erzurum,Pasinler
60-64,450,475,925,Erzurum,Pasinler
65-69,343,372,715,Erzurum,Pasinler
70-74,243,353,596,Erzurum,Pasinler
75+,337,497,834,Erzurum,Pasinler
18-24,6908,7746,14654,Mardin,Nusaybin
25-29,4105,4195,8300,Mardin,Nusaybin
30-34,3444,3601,7045,Mardin,Nusaybin
35-39,3184,3321,6505,Mardin,Nusaybin
40-44,2544,2825,5369,Mardin,Nusaybin
45-49,2222,2231,4453,Mardin,Nusaybin
50-54,1789,1744,3533,Mardin,Nusaybin
55-59,1285,1391,2676,Mardin,Nusaybin
60-64,1105,1195,2300,Mardin,Nusaybin
65-69,804,1106,1910,Mardin,Nusaybin
70-74,622,787,1409,Mardin,Nusaybin
75+,1085,1549,2634,Mardin,Nusaybin
18-24,1285,1128,2413,Diyarbakır,Hazro
25-29,702,638,1340,Diyarbakır,Hazro
30-34,506,515,1021,Diyarbakır,Hazro
35-39,463,455,918,Diyarbakır,Hazro
40-44,352,382,734,Diyarbakır,Hazro
45-49,303,323,626,Diyarbakır,Hazro
50-54,277,315,592,Diyarbakır,Hazro
55-59,205,222,427,Diyarbakır,Hazro
60-64,227,197,424,Diyarbakır,Hazro
65-69,161,228,389,Diyarbakır,Hazro
70-74,115,158,273,Diyarbakır,Hazro
75+,181,288,469,Diyarbakır,Hazro
18-24,5809,6058,11867,Mersin,Silifke
25-29,3391,3309,6700,Mersin,Silifke
30-34,3650,3759,7409,Mersin,Silifke
35-39,4346,4372,8718,Mersin,Silifke
40-44,4493,4554,9047,Mersin,Silifke
45-49,4593,4801,9394,Mersin,Silifke
50-54,4379,4506,8885,Mersin,Silifke
55-59,3815,3899,7714,Mersin,Silifke
60-64,3389,3308,6697,Mersin,Silifke
65-69,2464,2459,4923,Mersin,Silifke
70-74,1753,1929,3682,Mersin,Silifke
75+,2583,3121,5704,Mersin,Silifke
18-24,1650,1682,3332,Elazığ,Karakoçan
25-29,1109,1061,2170,Elazığ,Karakoçan
30-34,1118,1022,2140,Elazığ,Karakoçan
35-39,976,966,1942,Elazığ,Karakoçan
40-44,767,862,1629,Elazığ,Karakoçan
45-49,825,903,1728,Elazığ,Karakoçan
50-54,643,691,1334,Elazığ,Karakoçan
55-59,587,627,1214,Elazığ,Karakoçan
60-64,586,654,1240,Elazığ,Karakoçan
65-69,461,559,1020,Elazığ,Karakoçan
70-74,334,467,801,Elazığ,Karakoçan
75+,675,818,1493,Elazığ,Karakoçan
18-24,1657,1532,3189,Afyonkarahisar,İscehisar
25-29,980,949,1929,Afyonkarahisar,İscehisar
30-34,911,848,1759,Afyonkarahisar,İscehisar
35-39,908,880,1788,Afyonkarahisar,İscehisar
40-44,777,777,1554,Afyonkarahisar,İscehisar
45-49,701,709,1410,Afyonkarahisar,İscehisar
50-54,593,602,1195,Afyonkarahisar,İscehisar
55-59,533,545,1078,Afyonkarahisar,İscehisar
60-64,376,402,778,Afyonkarahisar,İscehisar
65-69,280,350,630,Afyonkarahisar,İscehisar
70-74,185,271,456,Afyonkarahisar,İscehisar
75+,377,440,817,Afyonkarahisar,İscehisar
18-24,999,1038,2037,Manisa,Selendi
25-29,572,536,1108,Manisa,Selendi
30-34,599,601,1200,Manisa,Selendi
35-39,596,616,1212,Manisa,Selendi
40-44,698,701,1399,Manisa,Selendi
45-49,721,726,1447,Manisa,Selendi
50-54,726,735,1461,Manisa,Selendi
55-59,736,741,1477,Manisa,Selendi
60-64,612,690,1302,Manisa,Selendi
65-69,522,569,1091,Manisa,Selendi
70-74,399,462,861,Manisa,Selendi
75+,657,773,1430,Manisa,Selendi
18-24,417,410,827,Bolu,Yeniçağa
25-29,218,178,396,Bolu,Yeniçağa
30-34,175,174,349,Bolu,Yeniçağa
35-39,215,204,419,Bolu,Yeniçağa
40-44,213,219,432,Bolu,Yeniçağa
45-49,266,250,516,Bolu,Yeniçağa
50-54,240,260,500,Bolu,Yeniçağa
55-59,253,270,523,Bolu,Yeniçağa
60-64,246,263,509,Bolu,Yeniçağa
65-69,202,240,442,Bolu,Yeniçağa
70-74,129,191,320,Bolu,Yeniçağa
75+,211,353,564,Bolu,Yeniçağa
18-24,848,762,1610,Niğde,Ulukışla
25-29,533,489,1022,Niğde,Ulukışla
30-34,534,421,955,Niğde,Ulukışla
35-39,614,528,1142,Niğde,Ulukışla
40-44,579,556,1135,Niğde,Ulukışla
45-49,660,671,1331,Niğde,Ulukışla
50-54,758,822,1580,Niğde,Ulukışla
55-59,827,898,1725,Niğde,Ulukışla
60-64,779,777,1556,Niğde,Ulukışla
65-69,614,706,1320,Niğde,Ulukışla
70-74,483,568,1051,Niğde,Ulukışla
75+,648,955,1603,Niğde,Ulukışla
18-24,781,736,1517,Rize,Güneysu
25-29,417,386,803,Rize,Güneysu
30-34,420,344,764,Rize,Güneysu
35-39,374,418,792,Rize,Güneysu
40-44,427,426,853,Rize,Güneysu
45-49,520,510,1030,Rize,Güneysu
50-54,543,508,1051,Rize,Güneysu
55-59,453,454,907,Rize,Güneysu
60-64,413,472,885,Rize,Güneysu
65-69,295,376,671,Rize,Güneysu
70-74,254,314,568,Rize,Güneysu
75+,271,515,786,Rize,Güneysu
18-24,447,385,832,Erzincan,Refahiye
25-29,282,236,518,Erzincan,Refahiye
30-34,274,212,486,Erzincan,Refahiye
35-39,296,191,487,Erzincan,Refahiye
40-44,241,198,439,Erzincan,Refahiye
45-49,272,215,487,Erzincan,Refahiye
50-54,285,319,604,Erzincan,Refahiye
55-59,379,424,803,Erzincan,Refahiye
60-64,559,520,1079,Erzincan,Refahiye
65-69,501,464,965,Erzincan,Refahiye
70-74,376,432,808,Erzincan,Refahiye
75+,568,774,1342,Erzincan,Refahiye
18-24,348,357,705,Ordu,Gülyalı
25-29,273,211,484,Ordu,Gülyalı
30-34,184,161,345,Ordu,Gülyalı
35-39,242,211,453,Ordu,Gülyalı
40-44,218,228,446,Ordu,Gülyalı
45-49,275,288,563,Ordu,Gülyalı
50-54,319,324,643,Ordu,Gülyalı
55-59,349,326,675,Ordu,Gülyalı
60-64,318,324,642,Ordu,Gülyalı
65-69,266,261,527,Ordu,Gülyalı
70-74,184,211,395,Ordu,Gülyalı
75+,350,533,883,Ordu,Gülyalı
18-24,1770,1827,3597,Gaziantep,Oğuzeli
25-29,1154,1025,2179,Gaziantep,Oğuzeli
30-34,1058,937,1995,Gaziantep,Oğuzeli
35-39,980,881,1861,Gaziantep,Oğuzeli
40-44,855,841,1696,Gaziantep,Oğuzeli
45-49,770,755,1525,Gaziantep,Oğuzeli
50-54,755,643,1398,Gaziantep,Oğuzeli
55-59,575,631,1206,Gaziantep,Oğuzeli
60-64,511,549,1060,Gaziantep,Oğuzeli
65-69,431,496,927,Gaziantep,Oğuzeli
70-74,367,438,805,Gaziantep,Oğuzeli
75+,444,768,1212,Gaziantep,Oğuzeli
18-24,14901,15497,30398,İzmir,Bayraklı
25-29,11403,11905,23308,İzmir,Bayraklı
30-34,12798,12846,25644,İzmir,Bayraklı
35-39,14378,14574,28952,İzmir,Bayraklı
40-44,13287,13284,26571,İzmir,Bayraklı
45-49,11388,11629,23017,İzmir,Bayraklı
50-54,9960,9896,19856,İzmir,Bayraklı
55-59,8367,8638,17005,İzmir,Bayraklı
60-64,6955,7429,14384,İzmir,Bayraklı
65-69,5274,5875,11149,İzmir,Bayraklı
70-74,3550,3928,7478,İzmir,Bayraklı
75+,3407,5058,8465,İzmir,Bayraklı
18-24,368,308,676,Kilis,Polateli
25-29,178,138,316,Kilis,Polateli
30-34,136,118,254,Kilis,Polateli
35-39,130,137,267,Kilis,Polateli
40-44,142,140,282,Kilis,Polateli
45-49,139,150,289,Kilis,Polateli
50-54,130,140,270,Kilis,Polateli
55-59,103,102,205,Kilis,Polateli
60-64,86,93,179,Kilis,Polateli
65-69,97,95,192,Kilis,Polateli
70-74,69,64,133,Kilis,Polateli
75+,95,137,232,Kilis,Polateli
18-24,867,890,1757,Sinop,Durağan
25-29,491,519,1010,Sinop,Durağan
30-34,460,491,951,Sinop,Durağan
35-39,517,529,1046,Sinop,Durağan
40-44,495,461,956,Sinop,Durağan
45-49,462,436,898,Sinop,Durağan
50-54,506,537,1043,Sinop,Durağan
55-59,479,591,1070,Sinop,Durağan
60-64,615,616,1231,Sinop,Durağan
65-69,524,547,1071,Sinop,Durağan
70-74,424,481,905,Sinop,Durağan
75+,587,666,1253,Sinop,Durağan
18-24,511,480,991,Sivas,Ulaş
25-29,321,248,569,Sivas,Ulaş
30-34,310,218,528,Sivas,Ulaş
35-39,283,259,542,Sivas,Ulaş
40-44,248,207,455,Sivas,Ulaş
45-49,265,224,489,Sivas,Ulaş
50-54,252,256,508,Sivas,Ulaş
55-59,263,228,491,Sivas,Ulaş
60-64,271,249,520,Sivas,Ulaş
65-69,222,266,488,Sivas,Ulaş
70-74,208,207,415,Sivas,Ulaş
75+,236,301,537,Sivas,Ulaş
18-24,293,225,518,Konya,Derebucak
25-29,214,148,362,Konya,Derebucak
30-34,180,127,307,Konya,Derebucak
35-39,151,133,284,Konya,Derebucak
40-44,155,144,299,Konya,Derebucak
45-49,178,199,377,Konya,Derebucak
50-54,216,254,470,Konya,Derebucak
55-59,236,230,466,Konya,Derebucak
60-64,188,226,414,Konya,Derebucak
65-69,198,264,462,Konya,Derebucak
70-74,170,240,410,Konya,Derebucak
75+,312,412,724,Konya,Derebucak
18-24,453,356,809,Kilis,Elbeyli
25-29,397,143,540,Kilis,Elbeyli
30-34,211,151,362,Kilis,Elbeyli
35-39,191,137,328,Kilis,Elbeyli
40-44,161,139,300,Kilis,Elbeyli
45-49,143,128,271,Kilis,Elbeyli
50-54,128,125,253,Kilis,Elbeyli
55-59,137,124,261,Kilis,Elbeyli
60-64,119,134,253,Kilis,Elbeyli
65-69,101,148,249,Kilis,Elbeyli
70-74,79,99,178,Kilis,Elbeyli
75+,101,157,258,Kilis,Elbeyli
18-24,846,826,1672,Afyonkarahisar,Çobanlar
25-29,507,476,983,Afyonkarahisar,Çobanlar
30-34,509,506,1015,Afyonkarahisar,Çobanlar
35-39,562,522,1084,Afyonkarahisar,Çobanlar
40-44,394,411,805,Afyonkarahisar,Çobanlar
45-49,393,391,784,Afyonkarahisar,Çobanlar
50-54,335,313,648,Afyonkarahisar,Çobanlar
55-59,301,318,619,Afyonkarahisar,Çobanlar
60-64,236,238,474,Afyonkarahisar,Çobanlar
65-69,187,203,390,Afyonkarahisar,Çobanlar
70-74,95,117,212,Afyonkarahisar,Çobanlar
75+,143,182,325,Afyonkarahisar,Çobanlar
18-24,3519,3495,7014,Muş,Malazgirt
25-29,1943,1812,3755,Muş,Malazgirt
30-34,1457,1397,2854,Muş,Malazgirt
35-39,1390,1378,2768,Muş,Malazgirt
40-44,1245,1073,2318,Muş,Malazgirt
45-49,1141,968,2109,Muş,Malazgirt
50-54,926,738,1664,Muş,Malazgirt
55-59,719,675,1394,Muş,Malazgirt
60-64,669,654,1323,Muş,Malazgirt
65-69,431,598,1029,Muş,Malazgirt
70-74,298,390,688,Muş,Malazgirt
75+,366,584,950,Muş,Malazgirt
18-24,1468,1445,2913,Zonguldak,Kilimli
25-29,1030,1088,2118,Zonguldak,Kilimli
30-34,1415,1364,2779,Zonguldak,Kilimli
35-39,1713,1475,3188,Zonguldak,Kilimli
40-44,1408,1335,2743,Zonguldak,Kilimli
45-49,1185,1164,2349,Zonguldak,Kilimli
50-54,1177,1259,2436,Zonguldak,Kilimli
55-59,1313,1385,2698,Zonguldak,Kilimli
60-64,1114,1101,2215,Zonguldak,Kilimli
65-69,767,791,1558,Zonguldak,Kilimli
70-74,372,538,910,Zonguldak,Kilimli
75+,522,1011,1533,Zonguldak,Kilimli
18-24,968,1080,2048,Nevşehir,Gülşehir
25-29,583,595,1178,Nevşehir,Gülşehir
30-34,682,631,1313,Nevşehir,Gülşehir
35-39,691,693,1384,Nevşehir,Gülşehir
40-44,678,640,1318,Nevşehir,Gülşehir
45-49,686,708,1394,Nevşehir,Gülşehir
50-54,683,801,1484,Nevşehir,Gülşehir
55-59,709,790,1499,Nevşehir,Gülşehir
60-64,630,763,1393,Nevşehir,Gülşehir
65-69,586,681,1267,Nevşehir,Gülşehir
70-74,384,486,870,Nevşehir,Gülşehir
75+,522,784,1306,Nevşehir,Gülşehir
18-24,511,461,972,Eskişehir,Alpu
25-29,310,305,615,Eskişehir,Alpu
30-34,351,285,636,Eskişehir,Alpu
35-39,373,303,676,Eskişehir,Alpu
40-44,358,314,672,Eskişehir,Alpu
45-49,388,357,745,Eskişehir,Alpu
50-54,473,464,937,Eskişehir,Alpu
55-59,450,434,884,Eskişehir,Alpu
60-64,370,365,735,Eskişehir,Alpu
65-69,295,352,647,Eskişehir,Alpu
70-74,226,276,502,Eskişehir,Alpu
75+,346,497,843,Eskişehir,Alpu
18-24,743,798,1541,Sakarya,Karapürçek
25-29,462,410,872,Sakarya,Karapürçek
30-34,478,446,924,Sakarya,Karapürçek
35-39,490,427,917,Sakarya,Karapürçek
40-44,419,379,798,Sakarya,Karapürçek
45-49,404,402,806,Sakarya,Karapürçek
50-54,370,378,748,Sakarya,Karapürçek
55-59,380,305,685,Sakarya,Karapürçek
60-64,265,287,552,Sakarya,Karapürçek
65-69,201,191,392,Sakarya,Karapürçek
70-74,142,152,294,Sakarya,Karapürçek
75+,178,281,459,Sakarya,Karapürçek
18-24,6712,6950,13662,Antalya,Konyaaltı
25-29,4828,5215,10043,Antalya,Konyaaltı
30-34,5886,6660,12546,Antalya,Konyaaltı
35-39,7091,7969,15060,Antalya,Konyaaltı
40-44,6911,7300,14211,Antalya,Konyaaltı
45-49,6050,6276,12326,Antalya,Konyaaltı
50-54,5189,5404,10593,Antalya,Konyaaltı
55-59,4294,4637,8931,Antalya,Konyaaltı
60-64,3654,3750,7404,Antalya,Konyaaltı
65-69,2608,2536,5144,Antalya,Konyaaltı
70-74,1678,1559,3237,Antalya,Konyaaltı
75+,1633,2024,3657,Antalya,Konyaaltı
18-24,2868,2849,5717,Samsun,Tekkeköy
25-29,1864,1741,3605,Samsun,Tekkeköy
30-34,1905,1773,3678,Samsun,Tekkeköy
35-39,1992,1911,3903,Samsun,Tekkeköy
40-44,1820,1712,3532,Samsun,Tekkeköy
45-49,1613,1612,3225,Samsun,Tekkeköy
50-54,1734,1706,3440,Samsun,Tekkeköy
55-59,1582,1522,3104,Samsun,Tekkeköy
60-64,1285,1312,2597,Samsun,Tekkeköy
65-69,933,987,1920,Samsun,Tekkeköy
70-74,571,717,1288,Samsun,Tekkeköy
75+,802,1308,2110,Samsun,Tekkeköy
18-24,1428,1369,2797,İstanbul,Şile
25-29,1178,1017,2195,İstanbul,Şile
30-34,1095,999,2094,İstanbul,Şile
35-39,1206,1094,2300,İstanbul,Şile
40-44,1052,1013,2065,İstanbul,Şile
45-49,1123,1100,2223,İstanbul,Şile
50-54,1239,1122,2361,İstanbul,Şile
55-59,1243,1188,2431,İstanbul,Şile
60-64,1189,1208,2397,İstanbul,Şile
65-69,992,1041,2033,İstanbul,Şile
70-74,790,784,1574,İstanbul,Şile
75+,1132,1310,2442,İstanbul,Şile
18-24,828,812,1640,Bilecik,Söğüt
25-29,570,561,1131,Bilecik,Söğüt
30-34,594,620,1214,Bilecik,Söğüt
35-39,701,626,1327,Bilecik,Söğüt
40-44,604,600,1204,Bilecik,Söğüt
45-49,584,602,1186,Bilecik,Söğüt
50-54,586,584,1170,Bilecik,Söğüt
55-59,635,619,1254,Bilecik,Söğüt
60-64,505,528,1033,Bilecik,Söğüt
65-69,358,383,741,Bilecik,Söğüt
70-74,248,337,585,Bilecik,Söğüt
75+,427,629,1056,Bilecik,Söğüt
18-24,426,344,770,Ordu,Çamaş
25-29,211,175,386,Ordu,Çamaş
30-34,211,163,374,Ordu,Çamaş
35-39,235,214,449,Ordu,Çamaş
40-44,285,247,532,Ordu,Çamaş
45-49,296,254,550,Ordu,Çamaş
50-54,376,368,744,Ordu,Çamaş
55-59,371,368,739,Ordu,Çamaş
60-64,332,370,702,Ordu,Çamaş
65-69,291,341,632,Ordu,Çamaş
70-74,195,226,421,Ordu,Çamaş
75+,211,358,569,Ordu,Çamaş
18-24,128,116,244,Eskişehir,Mihalgazi
25-29,57,70,127,Eskişehir,Mihalgazi
30-34,79,82,161,Eskişehir,Mihalgazi
35-39,85,84,169,Eskişehir,Mihalgazi
40-44,105,90,195,Eskişehir,Mihalgazi
45-49,105,111,216,Eskişehir,Mihalgazi
50-54,136,130,266,Eskişehir,Mihalgazi
55-59,132,126,258,Eskişehir,Mihalgazi
60-64,94,117,211,Eskişehir,Mihalgazi
65-69,90,146,236,Eskişehir,Mihalgazi
70-74,92,103,195,Eskişehir,Mihalgazi
75+,165,199,364,Eskişehir,Mihalgazi
18-24,1303,1328,2631,Sivas,Suşehri
25-29,735,752,1487,Sivas,Suşehri
30-34,773,726,1499,Sivas,Suşehri
35-39,780,767,1547,Sivas,Suşehri
40-44,797,747,1544,Sivas,Suşehri
45-49,745,724,1469,Sivas,Suşehri
50-54,738,676,1414,Sivas,Suşehri
55-59,726,780,1506,Sivas,Suşehri
60-64,851,854,1705,Sivas,Suşehri
65-69,703,836,1539,Sivas,Suşehri
70-74,502,674,1176,Sivas,Suşehri
75+,702,887,1589,Sivas,Suşehri
18-24,2868,3058,5926,Denizli,Çivril
25-29,1768,1712,3480,Denizli,Çivril
30-34,2008,1834,3842,Denizli,Çivril
35-39,2061,1900,3961,Denizli,Çivril
40-44,2071,1971,4042,Denizli,Çivril
45-49,2014,1960,3974,Denizli,Çivril
50-54,1924,2033,3957,Denizli,Çivril
55-59,1919,1961,3880,Denizli,Çivril
60-64,1657,1898,3555,Denizli,Çivril
65-69,1471,1738,3209,Denizli,Çivril
70-74,1014,1304,2318,Denizli,Çivril
75+,1553,2290,3843,Denizli,Çivril
18-24,6818,6713,13531,Balıkesir,Bandırma
25-29,5317,5192,10509,Balıkesir,Bandırma
30-34,5837,5439,11276,Balıkesir,Bandırma
35-39,6088,6063,12151,Balıkesir,Bandırma
40-44,5566,5565,11131,Balıkesir,Bandırma
45-49,5179,5352,10531,Balıkesir,Bandırma
50-54,4863,5166,10029,Balıkesir,Bandırma
55-59,4767,4936,9703,Balıkesir,Bandırma
60-64,3907,4086,7993,Balıkesir,Bandırma
65-69,2901,3519,6420,Balıkesir,Bandırma
70-74,2114,2585,4699,Balıkesir,Bandırma
75+,2610,3915,6525,Balıkesir,Bandırma
18-24,23498,24571,48069,Adana,Yüreğir
25-29,16024,16181,32205,Adana,Yüreğir
30-34,16167,15694,31861,Adana,Yüreğir
35-39,16772,16151,32923,Adana,Yüreğir
40-44,14068,13387,27455,Adana,Yüreğir
45-49,11860,11484,23344,Adana,Yüreğir
50-54,10431,10127,20558,Adana,Yüreğir
55-59,8736,8994,17730,Adana,Yüreğir
60-64,7387,7734,15121,Adana,Yüreğir
65-69,5213,5863,11076,Adana,Yüreğir
70-74,2909,3757,6666,Adana,Yüreğir
75+,3343,5163,8506,Adana,Yüreğir
18-24,1483,1598,3081,Bolu,Gerede
25-29,1014,1016,2030,Bolu,Gerede
30-34,1085,1003,2088,Bolu,Gerede
35-39,1203,1039,2242,Bolu,Gerede
40-44,1084,1031,2115,Bolu,Gerede
45-49,1069,1088,2157,Bolu,Gerede
50-54,908,984,1892,Bolu,Gerede
55-59,944,1053,1997,Bolu,Gerede
60-64,974,1091,2065,Bolu,Gerede
65-69,878,1023,1901,Bolu,Gerede
70-74,671,764,1435,Bolu,Gerede
75+,999,1319,2318,Bolu,Gerede
18-24,259,253,512,Kastamonu,İhsangazi
25-29,161,120,281,Kastamonu,İhsangazi
30-34,145,132,277,Kastamonu,İhsangazi
35-39,159,164,323,Kastamonu,İhsangazi
40-44,161,131,292,Kastamonu,İhsangazi
45-49,146,172,318,Kastamonu,İhsangazi
50-54,172,194,366,Kastamonu,İhsangazi
55-59,208,184,392,Kastamonu,İhsangazi
60-64,222,237,459,Kastamonu,İhsangazi
65-69,174,223,397,Kastamonu,İhsangazi
70-74,124,161,285,Kastamonu,İhsangazi
75+,154,217,371,Kastamonu,İhsangazi
18-24,6089,6525,12614,Kilis,Kilis Merkez
25-29,4892,4027,8919,Kilis,Kilis Merkez
30-34,3960,3783,7743,Kilis,Kilis Merkez
35-39,3627,3699,7326,Kilis,Kilis Merkez
40-44,3208,3212,6420,Kilis,Kilis Merkez
45-49,2976,2888,5864,Kilis,Kilis Merkez
50-54,2708,2642,5350,Kilis,Kilis Merkez
55-59,2210,2163,4373,Kilis,Kilis Merkez
60-64,1596,1651,3247,Kilis,Kilis Merkez
65-69,1304,1506,2810,Kilis,Kilis Merkez
70-74,892,1197,2089,Kilis,Kilis Merkez
75+,1381,2009,3390,Kilis,Kilis Merkez
18-24,31353,32082,63435,İstanbul,Sultangazi
25-29,23108,22630,45738,İstanbul,Sultangazi
30-34,23877,22790,46667,İstanbul,Sultangazi
35-39,25021,23280,48301,İstanbul,Sultangazi
40-44,20829,19204,40033,İstanbul,Sultangazi
45-49,17228,14936,32164,İstanbul,Sultangazi
50-54,13219,11370,24589,İstanbul,Sultangazi
55-59,9202,8614,17816,İstanbul,Sultangazi
60-64,6186,6542,12728,İstanbul,Sultangazi
65-69,3966,4454,8420,İstanbul,Sultangazi
70-74,2132,2708,4840,İstanbul,Sultangazi
75+,2052,3605,5657,İstanbul,Sultangazi
18-24,593,578,1171,Nevşehir,Kozaklı
25-29,367,435,802,Nevşehir,Kozaklı
30-34,407,395,802,Nevşehir,Kozaklı
35-39,455,384,839,Nevşehir,Kozaklı
40-44,390,408,798,Nevşehir,Kozaklı
45-49,442,430,872,Nevşehir,Kozaklı
50-54,500,511,1011,Nevşehir,Kozaklı
55-59,530,478,1008,Nevşehir,Kozaklı
60-64,466,510,976,Nevşehir,Kozaklı
65-69,410,481,891,Nevşehir,Kozaklı
70-74,290,377,667,Nevşehir,Kozaklı
75+,357,602,959,Nevşehir,Kozaklı
18-24,6287,6489,12776,Kars,Kars Merkez
25-29,4398,4699,9097,Kars,Kars Merkez
30-34,4354,4133,8487,Kars,Kars Merkez
35-39,4138,4102,8240,Kars,Kars Merkez
40-44,3633,3223,6856,Kars,Kars Merkez
45-49,3146,2675,5821,Kars,Kars Merkez
50-54,2695,2432,5127,Kars,Kars Merkez
55-59,2279,2113,4392,Kars,Kars Merkez
60-64,1776,1703,3479,Kars,Kars Merkez
65-69,1314,1392,2706,Kars,Kars Merkez
70-74,1024,1064,2088,Kars,Kars Merkez
75+,1209,1626,2835,Kars,Kars Merkez
18-24,629,635,1264,Sinop,Türkeli
25-29,400,407,807,Sinop,Türkeli
30-34,472,421,893,Sinop,Türkeli
35-39,473,429,902,Sinop,Türkeli
40-44,383,372,755,Sinop,Türkeli
45-49,416,390,806,Sinop,Türkeli
50-54,444,421,865,Sinop,Türkeli
55-59,509,606,1115,Sinop,Türkeli
60-64,526,567,1093,Sinop,Türkeli
65-69,497,496,993,Sinop,Türkeli
70-74,337,414,751,Sinop,Türkeli
75+,444,720,1164,Sinop,Türkeli
18-24,8383,8331,16714,Balıkesir,Altıeylül
25-29,6092,5666,11758,Balıkesir,Altıeylül
30-34,6005,6151,12156,Balıkesir,Altıeylül
35-39,6778,6820,13598,Balıkesir,Altıeylül
40-44,6621,6824,13445,Balıkesir,Altıeylül
45-49,6280,6382,12662,Balıkesir,Altıeylül
50-54,5886,5984,11870,Balıkesir,Altıeylül
55-59,5193,5468,10661,Balıkesir,Altıeylül
60-64,4400,4602,9002,Balıkesir,Altıeylül
65-69,3222,3595,6817,Balıkesir,Altıeylül
70-74,2143,2625,4768,Balıkesir,Altıeylül
75+,2934,4127,7061,Balıkesir,Altıeylül
18-24,1379,1507,2886,Aydın,Bozdoğan
25-29,959,894,1853,Aydın,Bozdoğan
30-34,1028,988,2016,Aydın,Bozdoğan
35-39,1126,999,2125,Aydın,Bozdoğan
40-44,1108,1021,2129,Aydın,Bozdoğan
45-49,1155,1081,2236,Aydın,Bozdoğan
50-54,1138,1107,2245,Aydın,Bozdoğan
55-59,1184,1195,2379,Aydın,Bozdoğan
60-64,1127,1093,2220,Aydın,Bozdoğan
65-69,808,884,1692,Aydın,Bozdoğan
70-74,621,739,1360,Aydın,Bozdoğan
75+,1070,1625,2695,Aydın,Bozdoğan
18-24,29449,31660,61109,Batman,Batman Merkez
25-29,19621,20350,39971,Batman,Batman Merkez
30-34,16368,16086,32454,Batman,Batman Merkez
35-39,16196,16242,32438,Batman,Batman Merkez
40-44,11816,11515,23331,Batman,Batman Merkez
45-49,9538,8929,18467,Batman,Batman Merkez
50-54,7743,6969,14712,Batman,Batman Merkez
55-59,5233,5077,10310,Batman,Batman Merkez
60-64,4174,4002,8176,Batman,Batman Merkez
65-69,2620,3404,6024,Batman,Batman Merkez
70-74,1592,2295,3887,Batman,Batman Merkez
75+,2378,3925,6303,Batman,Batman Merkez
18-24,1751,1629,3380,Van,Saray
25-29,895,735,1630,Van,Saray
30-34,675,625,1300,Van,Saray
35-39,597,581,1178,Van,Saray
40-44,432,388,820,Van,Saray
45-49,439,347,786,Van,Saray
50-54,373,366,739,Van,Saray
55-59,314,260,574,Van,Saray
60-64,184,269,453,Van,Saray
65-69,152,200,352,Van,Saray
70-74,91,90,181,Van,Saray
75+,133,125,258,Van,Saray
18-24,1196,1274,2470,Manisa,Gördes
25-29,668,645,1313,Manisa,Gördes
30-34,716,693,1409,Manisa,Gördes
35-39,834,872,1706,Manisa,Gördes
40-44,1046,1010,2056,Manisa,Gördes
45-49,1030,1080,2110,Manisa,Gördes
50-54,1066,1089,2155,Manisa,Gördes
55-59,1188,1201,2389,Manisa,Gördes
60-64,1043,1164,2207,Manisa,Gördes
65-69,786,863,1649,Manisa,Gördes
70-74,552,661,1213,Manisa,Gördes
75+,815,1267,2082,Manisa,Gördes
18-24,1173,1074,2247,Kayseri,Pınarbaşı
25-29,723,657,1380,Kayseri,Pınarbaşı
30-34,781,633,1414,Kayseri,Pınarbaşı
35-39,871,666,1537,Kayseri,Pınarbaşı
40-44,738,609,1347,Kayseri,Pınarbaşı
45-49,649,615,1264,Kayseri,Pınarbaşı
50-54,775,642,1417,Kayseri,Pınarbaşı
55-59,650,690,1340,Kayseri,Pınarbaşı
60-64,636,652,1288,Kayseri,Pınarbaşı
65-69,513,656,1169,Kayseri,Pınarbaşı
70-74,470,545,1015,Kayseri,Pınarbaşı
75+,698,926,1624,Kayseri,Pınarbaşı
18-24,18246,19128,37374,Mersin,Tarsus
25-29,11695,12064,23759,Mersin,Tarsus
30-34,12182,11999,24181,Mersin,Tarsus
35-39,12551,12661,25212,Mersin,Tarsus
40-44,11549,11479,23028,Mersin,Tarsus
45-49,10249,10593,20842,Mersin,Tarsus
50-54,10067,10035,20102,Mersin,Tarsus
55-59,8507,8855,17362,Mersin,Tarsus
60-64,7217,7504,14721,Mersin,Tarsus
65-69,5141,5677,10818,Mersin,Tarsus
70-74,3140,3937,7077,Mersin,Tarsus
75+,4002,5895,9897,Mersin,Tarsus
18-24,4164,3909,8073,Gümüşhane,Gümüşhane Merkez
25-29,1951,1819,3770,Gümüşhane,Gümüşhane Merkez
30-34,1954,1698,3652,Gümüşhane,Gümüşhane Merkez
35-39,1607,1472,3079,Gümüşhane,Gümüşhane Merkez
40-44,1320,1209,2529,Gümüşhane,Gümüşhane Merkez
45-49,1263,1226,2489,Gümüşhane,Gümüşhane Merkez
50-54,1342,1271,2613,Gümüşhane,Gümüşhane Merkez
55-59,1226,1228,2454,Gümüşhane,Gümüşhane Merkez
60-64,1092,1124,2216,Gümüşhane,Gümüşhane Merkez
65-69,744,830,1574,Gümüşhane,Gümüşhane Merkez
70-74,509,684,1193,Gümüşhane,Gümüşhane Merkez
75+,893,1313,2206,Gümüşhane,Gümüşhane Merkez
18-24,717,835,1552,Yozgat,Şefaatli
25-29,426,419,845,Yozgat,Şefaatli
30-34,424,397,821,Yozgat,Şefaatli
35-39,416,394,810,Yozgat,Şefaatli
40-44,427,456,883,Yozgat,Şefaatli
45-49,503,472,975,Yozgat,Şefaatli
50-54,575,540,1115,Yozgat,Şefaatli
55-59,562,535,1097,Yozgat,Şefaatli
60-64,442,495,937,Yozgat,Şefaatli
65-69,437,498,935,Yozgat,Şefaatli
70-74,269,359,628,Yozgat,Şefaatli
75+,361,565,926,Yozgat,Şefaatli
18-24,3607,3856,7463,Samsun,Terme
25-29,2032,2041,4073,Samsun,Terme
30-34,1925,1958,3883,Samsun,Terme
35-39,2223,2381,4604,Samsun,Terme
40-44,2273,2264,4537,Samsun,Terme
45-49,2332,2340,4672,Samsun,Terme
50-54,2651,2650,5301,Samsun,Terme
55-59,2718,2571,5289,Samsun,Terme
60-64,2444,2430,4874,Samsun,Terme
65-69,1863,1943,3806,Samsun,Terme
70-74,1269,1488,2757,Samsun,Terme
75+,1767,2658,4425,Samsun,Terme
18-24,12864,12245,25109,İstanbul,Beyoğlu
25-29,10344,8975,19319,İstanbul,Beyoğlu
30-34,10500,9125,19625,İstanbul,Beyoğlu
35-39,10605,9828,20433,İstanbul,Beyoğlu
40-44,9144,8686,17830,İstanbul,Beyoğlu
45-49,8686,8120,16806,İstanbul,Beyoğlu
50-54,7691,6967,14658,İstanbul,Beyoğlu
55-59,6231,5757,11988,İstanbul,Beyoğlu
60-64,4559,4408,8967,İstanbul,Beyoğlu
65-69,2850,3107,5957,İstanbul,Beyoğlu
70-74,1755,2139,3894,İstanbul,Beyoğlu
75+,2225,3968,6193,İstanbul,Beyoğlu
18-24,3325,3295,6620,Mersin,Anamur
25-29,1853,1907,3760,Mersin,Anamur
30-34,2019,2021,4040,Mersin,Anamur
35-39,2311,2385,4696,Mersin,Anamur
40-44,2396,2583,4979,Mersin,Anamur
45-49,2573,2581,5154,Mersin,Anamur
50-54,2482,2485,4967,Mersin,Anamur
55-59,2148,2117,4265,Mersin,Anamur
60-64,1738,1700,3438,Mersin,Anamur
65-69,1315,1403,2718,Mersin,Anamur
70-74,1053,1164,2217,Mersin,Anamur
75+,1599,1954,3553,Mersin,Anamur
18-24,503,551,1054,Muğla,Kavaklıdere
25-29,359,356,715,Muğla,Kavaklıdere
30-34,381,318,699,Muğla,Kavaklıdere
35-39,366,353,719,Muğla,Kavaklıdere
40-44,387,363,750,Muğla,Kavaklıdere
45-49,396,348,744,Muğla,Kavaklıdere
50-54,355,362,717,Muğla,Kavaklıdere
55-59,340,317,657,Muğla,Kavaklıdere
60-64,263,317,580,Muğla,Kavaklıdere
65-69,219,232,451,Muğla,Kavaklıdere
70-74,185,208,393,Muğla,Kavaklıdere
75+,305,468,773,Muğla,Kavaklıdere
18-24,3395,3164,6559,Şanlıurfa,Hilvan
25-29,1892,1703,3595,Şanlıurfa,Hilvan
30-34,1397,1297,2694,Şanlıurfa,Hilvan
35-39,1248,1258,2506,Şanlıurfa,Hilvan
40-44,1076,1024,2100,Şanlıurfa,Hilvan
45-49,855,831,1686,Şanlıurfa,Hilvan
50-54,869,800,1669,Şanlıurfa,Hilvan
55-59,605,643,1248,Şanlıurfa,Hilvan
60-64,449,438,887,Şanlıurfa,Hilvan
65-69,333,413,746,Şanlıurfa,Hilvan
70-74,249,335,584,Şanlıurfa,Hilvan
75+,318,539,857,Şanlıurfa,Hilvan
18-24,9256,9286,18542,Hakkari,Yüksekova
25-29,7894,5799,13693,Hakkari,Yüksekova
30-34,4584,4230,8814,Hakkari,Yüksekova
35-39,4665,4630,9295,Hakkari,Yüksekova
40-44,2842,2730,5572,Hakkari,Yüksekova
45-49,2188,2007,4195,Hakkari,Yüksekova
50-54,1911,1827,3738,Hakkari,Yüksekova
55-59,1425,1497,2922,Hakkari,Yüksekova
60-64,959,1157,2116,Hakkari,Yüksekova
65-69,682,923,1605,Hakkari,Yüksekova
70-74,479,563,1042,Hakkari,Yüksekova
75+,564,823,1387,Hakkari,Yüksekova
18-24,171,173,344,Erzincan,Kemaliye
25-29,123,128,251,Erzincan,Kemaliye
30-34,140,100,240,Erzincan,Kemaliye
35-39,120,107,227,Erzincan,Kemaliye
40-44,115,97,212,Erzincan,Kemaliye
45-49,134,110,244,Erzincan,Kemaliye
50-54,126,138,264,Erzincan,Kemaliye
55-59,175,153,328,Erzincan,Kemaliye
60-64,183,182,365,Erzincan,Kemaliye
65-69,204,193,397,Erzincan,Kemaliye
70-74,175,188,363,Erzincan,Kemaliye
75+,349,426,775,Erzincan,Kemaliye
18-24,9759,10805,20564,Karaman,Karaman Merkez
25-29,6563,6690,13253,Karaman,Karaman Merkez
30-34,7275,7094,14369,Karaman,Karaman Merkez
35-39,7258,6969,14227,Karaman,Karaman Merkez
40-44,6416,6568,12984,Karaman,Karaman Merkez
45-49,6033,6046,12079,Karaman,Karaman Merkez
50-54,5289,5425,10714,Karaman,Karaman Merkez
55-59,4391,4771,9162,Karaman,Karaman Merkez
60-64,3664,3880,7544,Karaman,Karaman Merkez
65-69,2861,3105,5966,Karaman,Karaman Merkez
70-74,1825,2178,4003,Karaman,Karaman Merkez
75+,2825,3737,6562,Karaman,Karaman Merkez
18-24,2175,2238,4413,Gümüşhane,Kelkit
25-29,1356,1211,2567,Gümüşhane,Kelkit
30-34,1309,1181,2490,Gümüşhane,Kelkit
35-39,1270,1109,2379,Gümüşhane,Kelkit
40-44,1115,1061,2176,Gümüşhane,Kelkit
45-49,1048,980,2028,Gümüşhane,Kelkit
50-54,1053,1017,2070,Gümüşhane,Kelkit
55-59,1105,1007,2112,Gümüşhane,Kelkit
60-64,949,924,1873,Gümüşhane,Kelkit
65-69,749,788,1537,Gümüşhane,Kelkit
70-74,462,683,1145,Gümüşhane,Kelkit
75+,837,1216,2053,Gümüşhane,Kelkit
18-24,2511,2606,5117,Balıkesir,Burhaniye
25-29,1682,1656,3338,Balıkesir,Burhaniye
30-34,1771,1849,3620,Balıkesir,Burhaniye
35-39,1977,2077,4054,Balıkesir,Burhaniye
40-44,1944,2006,3950,Balıkesir,Burhaniye
45-49,2027,2155,4182,Balıkesir,Burhaniye
50-54,1966,2235,4201,Balıkesir,Burhaniye
55-59,2245,2469,4714,Balıkesir,Burhaniye
60-64,2280,2219,4499,Balıkesir,Burhaniye
65-69,1824,1844,3668,Balıkesir,Burhaniye
70-74,1358,1402,2760,Balıkesir,Burhaniye
75+,1550,1783,3333,Balıkesir,Burhaniye
18-24,4677,4833,9510,Sakarya,Akyazı
25-29,3030,2917,5947,Sakarya,Akyazı
30-34,2987,2902,5889,Sakarya,Akyazı
35-39,3448,3322,6770,Sakarya,Akyazı
40-44,3220,3203,6423,Sakarya,Akyazı
45-49,2970,2804,5774,Sakarya,Akyazı
50-54,2725,2664,5389,Sakarya,Akyazı
55-59,2423,2396,4819,Sakarya,Akyazı
60-64,1983,2131,4114,Sakarya,Akyazı
65-69,1589,1516,3105,Sakarya,Akyazı
70-74,1054,1262,2316,Sakarya,Akyazı
75+,1362,2095,3457,Sakarya,Akyazı
18-24,8980,9471,18451,Samsun,Atakum
25-29,6385,7071,13456,Samsun,Atakum
30-34,7117,7551,14668,Samsun,Atakum
35-39,7288,8294,15582,Samsun,Atakum
40-44,7016,7436,14452,Samsun,Atakum
45-49,6153,6320,12473,Samsun,Atakum
50-54,5533,5941,11474,Samsun,Atakum
55-59,4981,5150,10131,Samsun,Atakum
60-64,4185,4161,8346,Samsun,Atakum
65-69,2988,2852,5840,Samsun,Atakum
70-74,1622,1832,3454,Samsun,Atakum
75+,1756,2566,4322,Samsun,Atakum
18-24,7244,7066,14310,Şanlıurfa,Suruç
25-29,4362,4122,8484,Şanlıurfa,Suruç
30-34,3477,3402,6879,Şanlıurfa,Suruç
35-39,3127,3137,6264,Şanlıurfa,Suruç
40-44,2296,2327,4623,Şanlıurfa,Suruç
45-49,1938,1828,3766,Şanlıurfa,Suruç
50-54,1890,1649,3539,Şanlıurfa,Suruç
55-59,1420,1435,2855,Şanlıurfa,Suruç
60-64,1047,1025,2072,Şanlıurfa,Suruç
65-69,751,937,1688,Şanlıurfa,Suruç
70-74,500,734,1234,Şanlıurfa,Suruç
75+,780,1218,1998,Şanlıurfa,Suruç
18-24,7817,8031,15848,Ağrı,Doğubayazıt
25-29,5496,5023,10519,Ağrı,Doğubayazıt
30-34,4179,3622,7801,Ağrı,Doğubayazıt
35-39,3854,3589,7443,Ağrı,Doğubayazıt
40-44,2980,2732,5712,Ağrı,Doğubayazıt
45-49,2217,1725,3942,Ağrı,Doğubayazıt
50-54,1975,1874,3849,Ağrı,Doğubayazıt
55-59,1685,1687,3372,Ağrı,Doğubayazıt
60-64,1314,1457,2771,Ağrı,Doğubayazıt
65-69,904,1123,2027,Ağrı,Doğubayazıt
70-74,690,758,1448,Ağrı,Doğubayazıt
75+,739,1155,1894,Ağrı,Doğubayazıt
18-24,20100,20216,40316,Eskişehir,Odunpazarı
25-29,14013,14078,28091,Eskişehir,Odunpazarı
30-34,14676,14829,29505,Eskişehir,Odunpazarı
35-39,15754,16607,32361,Eskişehir,Odunpazarı
40-44,14644,15668,30312,Eskişehir,Odunpazarı
45-49,13660,14704,28364,Eskişehir,Odunpazarı
50-54,12436,13378,25814,Eskişehir,Odunpazarı
55-59,11402,12298,23700,Eskişehir,Odunpazarı
60-64,9437,10038,19475,Eskişehir,Odunpazarı
65-69,6884,7657,14541,Eskişehir,Odunpazarı
70-74,4486,5516,10002,Eskişehir,Odunpazarı
75+,5508,8093,13601,Eskişehir,Odunpazarı
18-24,1412,1362,2774,Samsun,19 Mayıs
25-29,759,756,1515,Samsun,19 Mayıs
30-34,777,744,1521,Samsun,19 Mayıs
35-39,819,763,1582,Samsun,19 Mayıs
40-44,776,803,1579,Samsun,19 Mayıs
45-49,801,796,1597,Samsun,19 Mayıs
50-54,953,895,1848,Samsun,19 Mayıs
55-59,881,903,1784,Samsun,19 Mayıs
60-64,803,818,1621,Samsun,19 Mayıs
65-69,655,648,1303,Samsun,19 Mayıs
70-74,405,427,832,Samsun,19 Mayıs
75+,554,830,1384,Samsun,19 Mayıs
18-24,1253,1155,2408,Adana,Karaisalı
25-29,693,534,1227,Adana,Karaisalı
30-34,660,511,1171,Adana,Karaisalı
35-39,662,599,1261,Adana,Karaisalı
40-44,639,711,1350,Adana,Karaisalı
45-49,761,729,1490,Adana,Karaisalı
50-54,696,734,1430,Adana,Karaisalı
55-59,630,709,1339,Adana,Karaisalı
60-64,557,619,1176,Adana,Karaisalı
65-69,480,474,954,Adana,Karaisalı
70-74,341,424,765,Adana,Karaisalı
75+,612,858,1470,Adana,Karaisalı
18-24,632,701,1333,Aksaray,Sultanhanı
25-29,384,335,719,Aksaray,Sultanhanı
30-34,399,348,747,Aksaray,Sultanhanı
35-39,423,401,824,Aksaray,Sultanhanı
40-44,367,347,714,Aksaray,Sultanhanı
45-49,264,290,554,Aksaray,Sultanhanı
50-54,260,253,513,Aksaray,Sultanhanı
55-59,190,238,428,Aksaray,Sultanhanı
60-64,135,175,310,Aksaray,Sultanhanı
65-69,129,150,279,Aksaray,Sultanhanı
70-74,74,102,176,Aksaray,Sultanhanı
75+,89,164,253,Aksaray,Sultanhanı
18-24,31208,31799,63007,Ankara,Yenimahalle
25-29,24521,25510,50031,Ankara,Yenimahalle
30-34,26404,27920,54324,Ankara,Yenimahalle
35-39,27210,29213,56423,Ankara,Yenimahalle
40-44,24686,26390,51076,Ankara,Yenimahalle
45-49,22982,24196,47178,Ankara,Yenimahalle
50-54,20057,21237,41294,Ankara,Yenimahalle
55-59,17867,18644,36511,Ankara,Yenimahalle
60-64,14733,15204,29937,Ankara,Yenimahalle
65-69,10312,11030,21342,Ankara,Yenimahalle
70-74,6381,7514,13895,Ankara,Yenimahalle
75+,7324,11048,18372,Ankara,Yenimahalle
18-24,181,189,370,Aksaray,Sarıyahşi
25-29,146,116,262,Aksaray,Sarıyahşi
30-34,118,103,221,Aksaray,Sarıyahşi
35-39,129,114,243,Aksaray,Sarıyahşi
40-44,123,140,263,Aksaray,Sarıyahşi
45-49,154,148,302,Aksaray,Sarıyahşi
50-54,159,169,328,Aksaray,Sarıyahşi
55-59,171,187,358,Aksaray,Sarıyahşi
60-64,185,212,397,Aksaray,Sarıyahşi
65-69,160,189,349,Aksaray,Sarıyahşi
70-74,109,156,265,Aksaray,Sarıyahşi
75+,155,230,385,Aksaray,Sarıyahşi
18-24,378,419,797,Bursa,Büyükorhan
25-29,249,212,461,Bursa,Büyükorhan
30-34,273,216,489,Bursa,Büyükorhan
35-39,257,266,523,Bursa,Büyükorhan
40-44,264,278,542,Bursa,Büyükorhan
45-49,300,282,582,Bursa,Büyükorhan
50-54,332,375,707,Bursa,Büyükorhan
55-59,367,411,778,Bursa,Büyükorhan
60-64,405,457,862,Bursa,Büyükorhan
65-69,377,417,794,Bursa,Büyükorhan
70-74,241,342,583,Bursa,Büyükorhan
75+,416,519,935,Bursa,Büyükorhan
18-24,11951,12804,24755,Niğde,Niğde Merkez
25-29,7195,7447,14642,Niğde,Niğde Merkez
30-34,7612,7523,15135,Niğde,Niğde Merkez
35-39,8282,8250,16532,Niğde,Niğde Merkez
40-44,7370,7227,14597,Niğde,Niğde Merkez
45-49,6854,6810,13664,Niğde,Niğde Merkez
50-54,6028,5830,11858,Niğde,Niğde Merkez
55-59,4822,4905,9727,Niğde,Niğde Merkez
60-64,3624,3893,7517,Niğde,Niğde Merkez
65-69,2987,3155,6142,Niğde,Niğde Merkez
70-74,2019,2434,4453,Niğde,Niğde Merkez
75+,2408,3670,6078,Niğde,Niğde Merkez
18-24,25237,24684,49921,İstanbul,Kağıthane
25-29,20627,19404,40031,İstanbul,Kağıthane
30-34,20520,19181,39701,İstanbul,Kağıthane
35-39,20408,19640,40048,İstanbul,Kağıthane
40-44,17866,17761,35627,İstanbul,Kağıthane
45-49,16609,15823,32432,İstanbul,Kağıthane
50-54,14046,12939,26985,İstanbul,Kağıthane
55-59,10209,9357,19566,İstanbul,Kağıthane
60-64,6607,6633,13240,İstanbul,Kağıthane
65-69,3801,4455,8256,İstanbul,Kağıthane
70-74,2169,3083,5252,İstanbul,Kağıthane
75+,2972,5168,8140,İstanbul,Kağıthane
18-24,972,1066,2038,Artvin,Arhavi
25-29,679,666,1345,Artvin,Arhavi
30-34,720,680,1400,Artvin,Arhavi
35-39,730,711,1441,Artvin,Arhavi
40-44,651,685,1336,Artvin,Arhavi
45-49,714,779,1493,Artvin,Arhavi
50-54,752,726,1478,Artvin,Arhavi
55-59,728,660,1388,Artvin,Arhavi
60-64,741,623,1364,Artvin,Arhavi
65-69,389,466,855,Artvin,Arhavi
70-74,279,361,640,Artvin,Arhavi
75+,556,880,1436,Artvin,Arhavi
18-24,253,227,480,Kırıkkale,Sulakyurt
25-29,168,103,271,Kırıkkale,Sulakyurt
30-34,127,86,213,Kırıkkale,Sulakyurt
35-39,136,131,267,Kırıkkale,Sulakyurt
40-44,149,138,287,Kırıkkale,Sulakyurt
45-49,200,192,392,Kırıkkale,Sulakyurt
50-54,255,227,482,Kırıkkale,Sulakyurt
55-59,229,269,498,Kırıkkale,Sulakyurt
60-64,282,300,582,Kırıkkale,Sulakyurt
65-69,236,314,550,Kırıkkale,Sulakyurt
70-74,235,292,527,Kırıkkale,Sulakyurt
75+,389,476,865,Kırıkkale,Sulakyurt
18-24,4662,4991,9653,Bursa,Mustafakemalpaşa
25-29,3046,2991,6037,Bursa,Mustafakemalpaşa
30-34,3279,3183,6462,Bursa,Mustafakemalpaşa
35-39,3672,3447,7119,Bursa,Mustafakemalpaşa
40-44,3379,3471,6850,Bursa,Mustafakemalpaşa
45-49,3492,3669,7161,Bursa,Mustafakemalpaşa
50-54,3631,3647,7278,Bursa,Mustafakemalpaşa
55-59,3451,3597,7048,Bursa,Mustafakemalpaşa
60-64,3032,3068,6100,Bursa,Mustafakemalpaşa
65-69,2370,2672,5042,Bursa,Mustafakemalpaşa
70-74,1673,2108,3781,Bursa,Mustafakemalpaşa
75+,2152,3100,5252,Bursa,Mustafakemalpaşa
18-24,1353,1384,2737,İzmir,Kınık
25-29,914,911,1825,İzmir,Kınık
30-34,964,927,1891,İzmir,Kınık
35-39,1085,954,2039,İzmir,Kınık
40-44,984,1012,1996,İzmir,Kınık
45-49,1001,884,1885,İzmir,Kınık
50-54,881,860,1741,İzmir,Kınık
55-59,845,816,1661,İzmir,Kınık
60-64,679,791,1470,İzmir,Kınık
65-69,630,693,1323,İzmir,Kınık
70-74,416,515,931,İzmir,Kınık
75+,477,794,1271,İzmir,Kınık
18-24,1109,1083,2192,Düzce,Kaynaşlı
25-29,707,660,1367,Düzce,Kaynaşlı
30-34,710,691,1401,Düzce,Kaynaşlı
35-39,846,797,1643,Düzce,Kaynaşlı
40-44,788,762,1550,Düzce,Kaynaşlı
45-49,696,685,1381,Düzce,Kaynaşlı
50-54,670,649,1319,Düzce,Kaynaşlı
55-59,654,603,1257,Düzce,Kaynaşlı
60-64,512,571,1083,Düzce,Kaynaşlı
65-69,372,379,751,Düzce,Kaynaşlı
70-74,226,283,509,Düzce,Kaynaşlı
75+,335,486,821,Düzce,Kaynaşlı
18-24,466,524,990,Çorum,Kargı
25-29,343,293,636,Çorum,Kargı
30-34,339,324,663,Çorum,Kargı
35-39,345,368,713,Çorum,Kargı
40-44,369,334,703,Çorum,Kargı
45-49,391,424,815,Çorum,Kargı
50-54,471,471,942,Çorum,Kargı
55-59,625,705,1330,Çorum,Kargı
60-64,766,866,1632,Çorum,Kargı
65-69,798,833,1631,Çorum,Kargı
70-74,522,722,1244,Çorum,Kargı
75+,879,1138,2017,Çorum,Kargı
18-24,534,474,1008,Bingöl,Adaklı
25-29,496,284,780,Bingöl,Adaklı
30-34,298,236,534,Bingöl,Adaklı
35-39,280,239,519,Bingöl,Adaklı
40-44,220,191,411,Bingöl,Adaklı
45-49,160,162,322,Bingöl,Adaklı
50-54,186,212,398,Bingöl,Adaklı
55-59,221,205,426,Bingöl,Adaklı
60-64,222,223,445,Bingöl,Adaklı
65-69,218,262,480,Bingöl,Adaklı
70-74,142,171,313,Bingöl,Adaklı
75+,238,291,529,Bingöl,Adaklı
